,filename,additions,deletions,changes,date
0,docs/upgrade.html,91,30,121 ,"Oct 13, 2023"
1,connect/mirror/src/main/java/org/apache/kafka/connect/mirror/MirrorUtils.java,9,0,9 ,"Oct 13, 2023"
2,connect/mirror/src/test/java/org/apache/kafka/connect/mirror/MirrorUtilsTest.java,60,4,64 ,"Oct 13, 2023"
3,docs/documentation.html,3,1,4 ,"Oct 12, 2023"
4,connect/runtime/src/test/java/org/apache/kafka/connect/storage/MemoryConfigBackingStoreTest.java,185,0,185 ,"Oct 12, 2023"
5,streams/src/main/java/org/apache/kafka/streams/kstream/Aggregator.java,12,7,19 ,"Oct 16, 2023"
6,streams/src/main/java/org/apache/kafka/streams/kstream/Branched.java,62,45,107 ,"Oct 16, 2023"
7,streams/src/main/java/org/apache/kafka/streams/kstream/BranchedKStream.java,23,15,38 ,"Oct 16, 2023"
8,LICENSE-binary,2,2,4 ,"Oct 12, 2023"
9,gradle/dependencies.gradle,1,1,2 ,"Oct 12, 2023"
10,docs/ops.html,75,7,82 ,"Oct 17, 2023"
11,docs/toc.html,1,1,2 ,"Oct 17, 2023"
12,connect/runtime/src/main/java/org/apache/kafka/connect/runtime/rest/entities/TaskInfo.java,3,1,4 ,"Oct 14, 2023"
13,connect/runtime/src/main/java/org/apache/kafka/connect/runtime/rest/resources/ConnectorsResource.java,3,1,4 ,"Oct 14, 2023"
14,connect/runtime/src/test/java/org/apache/kafka/connect/integration/ConnectWorkerIntegrationTest.java,41,4,45 ,"Oct 14, 2023"
15,connect/runtime/src/test/java/org/apache/kafka/connect/util/clusters/EmbeddedConnectCluster.java,6,5,11 ,"Oct 14, 2023"
16,docs/connect.html,2,1,3 ,"Oct 14, 2023"
17,streams/src/main/java/org/apache/kafka/streams/KafkaStreams.java,25,15,40 ,"Oct 16, 2023"
18,streams/src/main/java/org/apache/kafka/streams/KeyQueryMetadata.java,3,3,6 ,"Oct 16, 2023"
19,streams/src/main/java/org/apache/kafka/streams/KeyValue.java,1,1,2 ,"Oct 16, 2023"
20,streams/src/main/java/org/apache/kafka/streams/StoreQueryParameters.java,1,1,2 ,"Oct 16, 2023"
21,streams/src/main/java/org/apache/kafka/streams/StreamsBuilder.java,4,4,8 ,"Oct 16, 2023"
22,streams/src/main/java/org/apache/kafka/streams/StreamsConfig.java,17,20,37 ,"Oct 16, 2023"
23,streams/src/main/java/org/apache/kafka/streams/StreamsMetadata.java,2,2,4 ,"Oct 16, 2023"
24,streams/src/main/java/org/apache/kafka/streams/StreamsMetrics.java,4,4,8 ,"Oct 16, 2023"
25,streams/src/main/java/org/apache/kafka/streams/Topology.java,1,1,2 ,"Oct 16, 2023"
26,streams/src/main/java/org/apache/kafka/streams/TopologyConfig.java,1,1,2 ,"Oct 16, 2023"
27,streams/src/main/java/org/apache/kafka/streams/KafkaStreams.java,11,0,11 ,"Oct 11, 2023"
28,streams/src/test/java/org/apache/kafka/streams/integration/RestoreIntegrationTest.java,203,4,207 ,"Oct 11, 2023"
29,storage/src/main/java/org/apache/kafka/storage/internals/log/AbstractIndex.java,2,2,4 ,"Oct 13, 2023"
30,core/src/main/scala/kafka/server/metadata/KRaftMetadataCache.scala,8,3,11 ,"Oct 16, 2023"
31,core/src/test/scala/integration/kafka/server/FetchFromFollowerIntegrationTest.scala,17,13,30 ,"Oct 16, 2023"
32,checkstyle/suppressions.xml,1,1,2 ,"Oct 13, 2023"
33,clients/src/main/java/org/apache/kafka/clients/consumer/internals/PrototypeAsyncConsumer.java,20,8,28 ,"Oct 13, 2023"
34,clients/src/test/java/org/apache/kafka/clients/consumer/internals/PrototypeAsyncConsumerTest.java,20,0,20 ,"Oct 13, 2023"
35,streams/examples/src/main/java/org/apache/kafka/streams/examples/pageview/PageViewTypedDemo.java,6,7,13 ,"Oct 14, 2023"
36,streams/examples/src/main/java/org/apache/kafka/streams/examples/pageview/PageViewUntypedDemo.java,2,2,4 ,"Oct 14, 2023"
37,streams/examples/src/main/java/org/apache/kafka/streams/examples/pipe/PipeDemo.java,4,4,8 ,"Oct 14, 2023"
38,streams/examples/src/main/java/org/apache/kafka/streams/examples/temperature/TemperatureDemo.java,10,10,20 ,"Oct 14, 2023"
39,streams/examples/src/main/java/org/apache/kafka/streams/examples/wordcount/WordCountDemo.java,2,2,4 ,"Oct 14, 2023"
40,streams/examples/src/main/java/org/apache/kafka/streams/examples/wordcount/WordCountProcessorDemo.java,2,2,4 ,"Oct 14, 2023"
41,streams/examples/src/main/java/org/apache/kafka/streams/examples/wordcount/WordCountTransformerDemo.java,2,5,7 ,"Oct 14, 2023"
42,streams/examples/src/test/java/org/apache/kafka/streams/examples/docs/DeveloperGuideTesting.java,4,5,9 ,"Oct 14, 2023"
43,core/src/test/scala/unit/kafka/log/remote/RemoteIndexCacheTest.scala,112,21,133 ,"Oct 16, 2023"
44,storage/src/main/java/org/apache/kafka/storage/internals/log/RemoteIndexCache.java,8,9,17 ,"Oct 16, 2023"
45,clients/src/main/java/org/apache/kafka/common/record/AbstractRecords.java,12,0,12 ,"Oct 16, 2023"
46,clients/src/main/java/org/apache/kafka/common/record/Records.java,8,0,8 ,"Oct 16, 2023"
47,clients/src/main/java/org/apache/kafka/common/utils/Utils.java,49,3,52 ,"Oct 16, 2023"
48,clients/src/test/java/org/apache/kafka/common/utils/UtilsTest.java,77,0,77 ,"Oct 16, 2023"
49,core/src/main/java/kafka/log/remote/RemoteLogManager.java,4,4,8 ,"Oct 16, 2023"
50,checkstyle/import-control.xml,1,0,1,"Oct 17, 2023"
51,core/src/main/scala/kafka/raft/KafkaNetworkChannel.scala,0,191,191 ,"Oct 17, 2023"
52,core/src/main/scala/kafka/raft/RaftManager.scala,1,1,2 ,"Oct 17, 2023"
53,bin/kafka-topics.sh,1,1,2 ,"Oct 17, 2023"
54,bin/windows/kafka-topics.bat,1,1,2 ,"Oct 17, 2023"
55,build.gradle,1,4,5 ,"Oct 17, 2023"
56,checkstyle/import-control.xml,3,0,3 ,"Oct 17, 2023"
57,core/src/test/scala/unit/kafka/server/FetchRequestTest.scala,15,15,30 ,"Oct 11, 2023"
58,build.gradle,1,1,2 ,"Oct 16, 2023"
59,docs/ops.html,4,4,8 ,"Oct 16, 2023"
60,checkstyle/suppressions.xml,1,1,2 ,"Oct 12, 2023"
61,core/src/main/scala/kafka/server/BrokerServer.scala,3,1,4 ,"Oct 12, 2023"
62,group-coordinator/src/main/java/org/apache/kafka/coordinator/group/Group.java,15,1,16 ,"Oct 12, 2023"
63,group-coordinator/src/main/java/org/apache/kafka/coordinator/group/GroupCoordinatorConfig.java,26,1,27 ,"Oct 12, 2023"
64,group-coordinator/src/main/java/org/apache/kafka/coordinator/group/GroupCoordinatorShard.java,66,3,69 ,"Oct 12, 2023"
65,group-coordinator/src/main/java/org/apache/kafka/coordinator/group/GroupMetadataManager.java,20,0,20 ,"Oct 12, 2023"
66,group-coordinator/src/main/java/org/apache/kafka/coordinator/group/OffsetExpirationCondition.java,36,0,36 ,"Oct 12, 2023"
67,group-coordinator/src/main/java/org/apache/kafka/coordinator/group/OffsetExpirationConditionImpl.java,62,0,62 ,"Oct 12, 2023"
68,core/src/main/scala/kafka/common/UnknownCodecException.scala,0,26,26 ,"Oct 17, 2023"
69,core/src/main/scala/kafka/server/AbstractFetcherThread.scala,6,5,11 ,"Oct 17, 2023"
70,core/src/main/scala/kafka/server/BrokerLifecycleManager.scala,2,2,4 ,"Oct 17, 2023"
71,core/src/main/scala/kafka/server/ClientRequestQuotaManager.scala,2,3,5 ,"Oct 17, 2023"
72,core/src/main/scala/kafka/server/ControllerConfigurationValidator.scala,5,5,10 ,"Oct 17, 2023"
73,core/src/main/scala/kafka/server/ControllerMutationQuotaManager.scala,0,1,1,"Oct 17, 2023"
74,core/src/main/scala/kafka/server/ControllerRegistrationManager.scala,4,4,8 ,"Oct 17, 2023"
75,core/src/main/scala/kafka/server/DelayedFetch.scala,4,2,6 ,"Oct 17, 2023"
76,core/src/main/scala/kafka/server/DelayedOperation.scala,1,1,2 ,"Oct 17, 2023"
77,core/src/main/scala/kafka/server/DelayedProduce.scala,2,2,4 ,"Oct 17, 2023"
78,streams/src/main/java/org/apache/kafka/streams/processor/internals/ReadOnlyTask.java,4,1,5 ,"Oct 12, 2023"
79,streams/src/main/java/org/apache/kafka/streams/processor/internals/TaskManager.java,1,4,5 ,"Oct 12, 2023"
80,streams/src/test/java/org/apache/kafka/streams/processor/internals/ReadOnlyTaskTest.java,26,0,26 ,"Oct 12, 2023"
81,streams/src/test/java/org/apache/kafka/streams/processor/internals/TaskManagerTest.java,26,0,26 ,"Oct 12, 2023"
82,clients/src/main/java/org/apache/kafka/common/config/ConfigDef.java,55,3,58 ,"Oct 11, 2023"
83,core/src/main/scala/kafka/cluster/Partition.scala,15,10,25 ,"Oct 11, 2023"
84,core/src/main/scala/kafka/cluster/Replica.scala,20,2,22 ,"Oct 11, 2023"
85,core/src/test/scala/unit/kafka/cluster/PartitionTest.scala,78,10,88 ,"Oct 11, 2023"
86,core/src/test/scala/unit/kafka/cluster/ReplicaTest.scala,56,3,59 ,"Oct 11, 2023"
87,core/src/test/scala/unit/kafka/server/IsrExpirationTest.scala,6,6,12 ,"Oct 11, 2023"
88,streams/src/main/java/org/apache/kafka/streams/KafkaStreams.java,3,3,6 ,"Oct 11, 2023"
89,build.gradle,4,0,4 ,"Oct 11, 2023"
90,gradle/dependencies.gradle,3,0,3 ,"Oct 11, 2023"
91,gradle/resources/dependencycheck-suppressions.xml,27,0,27 ,"Oct 11, 2023"
92,build.gradle,6,12,18 ,"Oct 12, 2023"
93,clients/src/main/java/org/apache/kafka/clients/consumer/internals/AbstractStickyAssignor.java,5,1,6 ,"Oct 12, 2023"
94,clients/src/main/java/org/apache/kafka/common/config/provider/FileConfigProvider.java,2,1,3 ,"Oct 12, 2023"
95,core/src/main/scala/kafka/metrics/LinuxIoMetricsCollector.scala,2,2,4 ,"Oct 12, 2023"
96,core/src/main/scala/kafka/server/PartitionMetadataFile.scala,1,1,2 ,"Oct 12, 2023"
97,generator/src/main/java/org/apache/kafka/message/MessageGenerator.java,3,2,5 ,"Oct 12, 2023"
98,gradle/dependencies.gradle,1,1,2 ,"Oct 12, 2023"
99,gradle/spotbugs-exclude.xml,41,1,42 ,"Oct 12, 2023"
100,raft/src/main/java/org/apache/kafka/raft/FileBasedStateStore.java,1,1,2 ,"Oct 12, 2023"
101,raft/src/main/java/org/apache/kafka/raft/ReplicatedCounter.java,3,2,5 ,"Oct 12, 2023"
102,server-common/src/main/java/org/apache/kafka/server/common/CheckpointFile.java,1,1,2 ,"Oct 12, 2023"
103,streams/src/main/java/org/apache/kafka/streams/state/internals/OffsetCheckpoint.java,1,1,2 ,"Oct 12, 2023"
104,metadata/src/main/java/org/apache/kafka/controller/metrics/QuorumControllerMetrics.java,2,2,4 ,"Oct 16, 2023"
105,metadata/src/test/java/org/apache/kafka/controller/metrics/QuorumControllerMetricsTest.java,16,0,16 ,"Oct 16, 2023"
106,docs/streams/tutorial.html,2,2,4 ,"Oct 13, 2023"
107,docs/upgrade.html,12,5,17 ,"Oct 12, 2023"
108,metadata/src/main/java/org/apache/kafka/controller/FeatureControlManager.java,3,2,5 ,"Oct 12, 2023"
109,metadata/src/test/java/org/apache/kafka/controller/FeatureControlManagerTest.java,1,2,3 ,"Oct 12, 2023"
110,tools/src/test/java/org/apache/kafka/tools/FeatureCommandTest.java,1,2,3 ,"Oct 12, 2023"
111,streams/src/test/java/org/apache/kafka/streams/state/internals/MeteredTimestampedKeyValueStoreTest.java,46,89,135 ,"Oct 11, 2023"
112,docs/upgrade.html,91,30,121 ,"Oct 13, 2023"
113,connect/mirror/src/main/java/org/apache/kafka/connect/mirror/MirrorUtils.java,9,0,9 ,"Oct 13, 2023"
114,connect/mirror/src/test/java/org/apache/kafka/connect/mirror/MirrorUtilsTest.java,60,4,64 ,"Oct 13, 2023"
115,docs/documentation.html,3,1,4 ,"Oct 12, 2023"
116,connect/runtime/src/test/java/org/apache/kafka/connect/storage/MemoryConfigBackingStoreTest.java,185,0,185 ,"Oct 12, 2023"
117,streams/src/main/java/org/apache/kafka/streams/kstream/Aggregator.java,12,7,19 ,"Oct 16, 2023"
118,streams/src/main/java/org/apache/kafka/streams/kstream/Branched.java,62,45,107 ,"Oct 16, 2023"
119,streams/src/main/java/org/apache/kafka/streams/kstream/BranchedKStream.java,23,15,38 ,"Oct 16, 2023"
120,LICENSE-binary,2,2,4 ,"Oct 12, 2023"
121,gradle/dependencies.gradle,1,1,2 ,"Oct 12, 2023"
122,docs/ops.html,75,7,82 ,"Oct 17, 2023"
123,docs/toc.html,1,1,2 ,"Oct 17, 2023"
124,connect/runtime/src/main/java/org/apache/kafka/connect/runtime/rest/entities/TaskInfo.java,3,1,4 ,"Oct 14, 2023"
125,connect/runtime/src/main/java/org/apache/kafka/connect/runtime/rest/resources/ConnectorsResource.java,3,1,4 ,"Oct 14, 2023"
126,connect/runtime/src/test/java/org/apache/kafka/connect/integration/ConnectWorkerIntegrationTest.java,41,4,45 ,"Oct 14, 2023"
127,connect/runtime/src/test/java/org/apache/kafka/connect/util/clusters/EmbeddedConnectCluster.java,6,5,11 ,"Oct 14, 2023"
128,docs/connect.html,2,1,3 ,"Oct 14, 2023"
129,streams/src/main/java/org/apache/kafka/streams/KafkaStreams.java,25,15,40 ,"Oct 16, 2023"
130,streams/src/main/java/org/apache/kafka/streams/KeyQueryMetadata.java,3,3,6 ,"Oct 16, 2023"
131,streams/src/main/java/org/apache/kafka/streams/KeyValue.java,1,1,2 ,"Oct 16, 2023"
132,streams/src/main/java/org/apache/kafka/streams/StoreQueryParameters.java,1,1,2 ,"Oct 16, 2023"
133,streams/src/main/java/org/apache/kafka/streams/StreamsBuilder.java,4,4,8 ,"Oct 16, 2023"
134,streams/src/main/java/org/apache/kafka/streams/StreamsConfig.java,17,20,37 ,"Oct 16, 2023"
135,streams/src/main/java/org/apache/kafka/streams/StreamsMetadata.java,2,2,4 ,"Oct 16, 2023"
136,streams/src/main/java/org/apache/kafka/streams/StreamsMetrics.java,4,4,8 ,"Oct 16, 2023"
137,streams/src/main/java/org/apache/kafka/streams/Topology.java,1,1,2 ,"Oct 16, 2023"
138,streams/src/main/java/org/apache/kafka/streams/TopologyConfig.java,1,1,2 ,"Oct 16, 2023"
139,streams/src/main/java/org/apache/kafka/streams/KafkaStreams.java,11,0,11 ,"Oct 11, 2023"
140,streams/src/test/java/org/apache/kafka/streams/integration/RestoreIntegrationTest.java,203,4,207 ,"Oct 11, 2023"
141,storage/src/main/java/org/apache/kafka/storage/internals/log/AbstractIndex.java,2,2,4 ,"Oct 13, 2023"
142,core/src/main/scala/kafka/server/metadata/KRaftMetadataCache.scala,8,3,11 ,"Oct 16, 2023"
143,core/src/test/scala/integration/kafka/server/FetchFromFollowerIntegrationTest.scala,17,13,30 ,"Oct 16, 2023"
144,checkstyle/suppressions.xml,1,1,2 ,"Oct 13, 2023"
145,clients/src/main/java/org/apache/kafka/clients/consumer/internals/PrototypeAsyncConsumer.java,20,8,28 ,"Oct 13, 2023"
146,clients/src/test/java/org/apache/kafka/clients/consumer/internals/PrototypeAsyncConsumerTest.java,20,0,20 ,"Oct 13, 2023"
147,streams/examples/src/main/java/org/apache/kafka/streams/examples/pageview/PageViewTypedDemo.java,6,7,13 ,"Oct 14, 2023"
148,streams/examples/src/main/java/org/apache/kafka/streams/examples/pageview/PageViewUntypedDemo.java,2,2,4 ,"Oct 14, 2023"
149,streams/examples/src/main/java/org/apache/kafka/streams/examples/pipe/PipeDemo.java,4,4,8 ,"Oct 14, 2023"
150,streams/examples/src/main/java/org/apache/kafka/streams/examples/temperature/TemperatureDemo.java,10,10,20 ,"Oct 14, 2023"
151,streams/examples/src/main/java/org/apache/kafka/streams/examples/wordcount/WordCountDemo.java,2,2,4 ,"Oct 14, 2023"
152,streams/examples/src/main/java/org/apache/kafka/streams/examples/wordcount/WordCountProcessorDemo.java,2,2,4 ,"Oct 14, 2023"
153,streams/examples/src/main/java/org/apache/kafka/streams/examples/wordcount/WordCountTransformerDemo.java,2,5,7 ,"Oct 14, 2023"
154,streams/examples/src/test/java/org/apache/kafka/streams/examples/docs/DeveloperGuideTesting.java,4,5,9 ,"Oct 14, 2023"
155,core/src/test/scala/unit/kafka/log/remote/RemoteIndexCacheTest.scala,112,21,133 ,"Oct 16, 2023"
156,storage/src/main/java/org/apache/kafka/storage/internals/log/RemoteIndexCache.java,8,9,17 ,"Oct 16, 2023"
157,clients/src/main/java/org/apache/kafka/common/record/AbstractRecords.java,12,0,12 ,"Oct 16, 2023"
158,clients/src/main/java/org/apache/kafka/common/record/Records.java,8,0,8 ,"Oct 16, 2023"
159,clients/src/main/java/org/apache/kafka/common/utils/Utils.java,49,3,52 ,"Oct 16, 2023"
160,clients/src/test/java/org/apache/kafka/common/utils/UtilsTest.java,77,0,77 ,"Oct 16, 2023"
161,core/src/main/java/kafka/log/remote/RemoteLogManager.java,4,4,8 ,"Oct 16, 2023"
162,checkstyle/import-control.xml,1,0,1,"Oct 17, 2023"
163,core/src/main/scala/kafka/raft/KafkaNetworkChannel.scala,0,191,191 ,"Oct 17, 2023"
164,core/src/main/scala/kafka/raft/RaftManager.scala,1,1,2 ,"Oct 17, 2023"
165,bin/kafka-topics.sh,1,1,2 ,"Oct 17, 2023"
166,bin/windows/kafka-topics.bat,1,1,2 ,"Oct 17, 2023"
167,build.gradle,1,4,5 ,"Oct 17, 2023"
168,checkstyle/import-control.xml,3,0,3 ,"Oct 17, 2023"
169,core/src/test/scala/unit/kafka/server/FetchRequestTest.scala,15,15,30 ,"Oct 11, 2023"
170,build.gradle,1,1,2 ,"Oct 16, 2023"
171,docs/ops.html,4,4,8 ,"Oct 16, 2023"
172,checkstyle/suppressions.xml,1,1,2 ,"Oct 12, 2023"
173,core/src/main/scala/kafka/server/BrokerServer.scala,3,1,4 ,"Oct 12, 2023"
174,group-coordinator/src/main/java/org/apache/kafka/coordinator/group/Group.java,15,1,16 ,"Oct 12, 2023"
175,group-coordinator/src/main/java/org/apache/kafka/coordinator/group/GroupCoordinatorConfig.java,26,1,27 ,"Oct 12, 2023"
176,group-coordinator/src/main/java/org/apache/kafka/coordinator/group/GroupCoordinatorShard.java,66,3,69 ,"Oct 12, 2023"
177,group-coordinator/src/main/java/org/apache/kafka/coordinator/group/GroupMetadataManager.java,20,0,20 ,"Oct 12, 2023"
178,group-coordinator/src/main/java/org/apache/kafka/coordinator/group/OffsetExpirationCondition.java,36,0,36 ,"Oct 12, 2023"
179,group-coordinator/src/main/java/org/apache/kafka/coordinator/group/OffsetExpirationConditionImpl.java,62,0,62 ,"Oct 12, 2023"
180,core/src/main/scala/kafka/common/UnknownCodecException.scala,0,26,26 ,"Oct 17, 2023"
181,core/src/main/scala/kafka/server/AbstractFetcherThread.scala,6,5,11 ,"Oct 17, 2023"
182,core/src/main/scala/kafka/server/BrokerLifecycleManager.scala,2,2,4 ,"Oct 17, 2023"
183,core/src/main/scala/kafka/server/ClientRequestQuotaManager.scala,2,3,5 ,"Oct 17, 2023"
184,core/src/main/scala/kafka/server/ControllerConfigurationValidator.scala,5,5,10 ,"Oct 17, 2023"
185,core/src/main/scala/kafka/server/ControllerMutationQuotaManager.scala,0,1,1,"Oct 17, 2023"
186,core/src/main/scala/kafka/server/ControllerRegistrationManager.scala,4,4,8 ,"Oct 17, 2023"
187,core/src/main/scala/kafka/server/DelayedFetch.scala,4,2,6 ,"Oct 17, 2023"
188,core/src/main/scala/kafka/server/DelayedOperation.scala,1,1,2 ,"Oct 17, 2023"
189,core/src/main/scala/kafka/server/DelayedProduce.scala,2,2,4 ,"Oct 17, 2023"
190,streams/src/main/java/org/apache/kafka/streams/processor/internals/ReadOnlyTask.java,4,1,5 ,"Oct 12, 2023"
191,streams/src/main/java/org/apache/kafka/streams/processor/internals/TaskManager.java,1,4,5 ,"Oct 12, 2023"
192,streams/src/test/java/org/apache/kafka/streams/processor/internals/ReadOnlyTaskTest.java,26,0,26 ,"Oct 12, 2023"
193,streams/src/test/java/org/apache/kafka/streams/processor/internals/TaskManagerTest.java,26,0,26 ,"Oct 12, 2023"
194,clients/src/main/java/org/apache/kafka/common/config/ConfigDef.java,55,3,58 ,"Oct 11, 2023"
195,core/src/main/scala/kafka/cluster/Partition.scala,15,10,25 ,"Oct 11, 2023"
196,core/src/main/scala/kafka/cluster/Replica.scala,20,2,22 ,"Oct 11, 2023"
197,core/src/test/scala/unit/kafka/cluster/PartitionTest.scala,78,10,88 ,"Oct 11, 2023"
198,core/src/test/scala/unit/kafka/cluster/ReplicaTest.scala,56,3,59 ,"Oct 11, 2023"
199,core/src/test/scala/unit/kafka/server/IsrExpirationTest.scala,6,6,12 ,"Oct 11, 2023"
200,streams/src/main/java/org/apache/kafka/streams/KafkaStreams.java,3,3,6 ,"Oct 11, 2023"
201,tests/kafkatest/tests/client/client_compatibility_features_test.py,3,1,4 ,"Oct 13, 2023"
202,tests/kafkatest/tests/client/client_compatibility_produce_consume_test.py,2,1,3 ,"Oct 13, 2023"
203,tests/kafkatest/tests/core/compatibility_test_new_broker_test.py,3,1,4 ,"Oct 13, 2023"
204,tests/kafkatest/tests/core/downgrade_test.py,5,1,6 ,"Oct 13, 2023"
205,tests/kafkatest/tests/core/upgrade_test.py,5,2,7 ,"Oct 13, 2023"
206,build.gradle,4,0,4 ,"Oct 11, 2023"
207,gradle/dependencies.gradle,3,0,3 ,"Oct 11, 2023"
208,gradle/resources/dependencycheck-suppressions.xml,27,0,27 ,"Oct 11, 2023"
209,build.gradle,6,12,18 ,"Oct 12, 2023"
210,clients/src/main/java/org/apache/kafka/clients/consumer/internals/AbstractStickyAssignor.java,5,1,6 ,"Oct 12, 2023"
211,clients/src/main/java/org/apache/kafka/common/config/provider/FileConfigProvider.java,2,1,3 ,"Oct 12, 2023"
212,core/src/main/scala/kafka/metrics/LinuxIoMetricsCollector.scala,2,2,4 ,"Oct 12, 2023"
213,core/src/main/scala/kafka/server/PartitionMetadataFile.scala,1,1,2 ,"Oct 12, 2023"
214,generator/src/main/java/org/apache/kafka/message/MessageGenerator.java,3,2,5 ,"Oct 12, 2023"
215,gradle/dependencies.gradle,1,1,2 ,"Oct 12, 2023"
216,gradle/spotbugs-exclude.xml,41,1,42 ,"Oct 12, 2023"
217,raft/src/main/java/org/apache/kafka/raft/FileBasedStateStore.java,1,1,2 ,"Oct 12, 2023"
218,raft/src/main/java/org/apache/kafka/raft/ReplicatedCounter.java,3,2,5 ,"Oct 12, 2023"
219,server-common/src/main/java/org/apache/kafka/server/common/CheckpointFile.java,1,1,2 ,"Oct 12, 2023"
220,streams/src/main/java/org/apache/kafka/streams/state/internals/OffsetCheckpoint.java,1,1,2 ,"Oct 12, 2023"
221,metadata/src/main/java/org/apache/kafka/controller/metrics/QuorumControllerMetrics.java,2,2,4 ,"Oct 16, 2023"
222,metadata/src/test/java/org/apache/kafka/controller/metrics/QuorumControllerMetricsTest.java,16,0,16 ,"Oct 16, 2023"
223,docs/streams/tutorial.html,2,2,4 ,"Oct 13, 2023"
224,docs/upgrade.html,12,5,17 ,"Oct 12, 2023"
225,metadata/src/main/java/org/apache/kafka/controller/FeatureControlManager.java,3,2,5 ,"Oct 12, 2023"
226,metadata/src/test/java/org/apache/kafka/controller/FeatureControlManagerTest.java,1,2,3 ,"Oct 12, 2023"
227,tools/src/test/java/org/apache/kafka/tools/FeatureCommandTest.java,1,2,3 ,"Oct 12, 2023"
228,streams/src/test/java/org/apache/kafka/streams/state/internals/MeteredTimestampedKeyValueStoreTest.java,46,89,135 ,"Oct 11, 2023"
229,LICENSE-binary,1,1,2 ,"Oct 2, 2023"
230,gradle/dependencies.gradle,1,1,2 ,"Oct 2, 2023"
231,build.gradle,1,1,2 ,"Oct 9, 2023"
232,gradle.properties,3,0,3 ,"Oct 9, 2023"
233,gradle/dependencies.gradle,2,5,7 ,"Oct 9, 2023"
234,core/src/main/scala/kafka/log/UnifiedLog.scala,24,31,55 ,"Oct 4, 2023"
235,core/src/main/scala/kafka/raft/KafkaMetadataLog.scala,3,3,6 ,"Oct 4, 2023"
236,core/src/main/scala/kafka/server/ReplicaManager.scala,45,47,92 ,"Oct 4, 2023"
237,core/src/test/scala/other/kafka/StressTestLog.scala,1,1,2 ,"Oct 4, 2023"
238,core/src/test/scala/unit/kafka/log/AbstractLogCleanerIntegrationTest.scala,1,1,2 ,"Oct 4, 2023"
239,core/src/test/scala/unit/kafka/log/LogCleanerParameterizedIntegrationTest.scala,3,3,6 ,"Oct 4, 2023"
240,clients/src/main/java/org/apache/kafka/common/Uuid.java,51,2,53 ,"Oct 6, 2023"
241,core/src/main/scala/kafka/log/LogManager.scala,37,0,37 ,"Oct 6, 2023"
242,core/src/main/scala/kafka/server/BrokerMetadataCheckpoint.scala,21,9,30 ,"Oct 6, 2023"
243,core/src/main/scala/kafka/server/KafkaServer.scala,3,2,5 ,"Oct 6, 2023"
244,core/src/main/scala/kafka/tools/StorageTool.scala,6,7,13 ,"Oct 6, 2023"
245,core/src/test/scala/kafka/server/BrokerMetadataCheckpointTest.scala,1,1,2 ,"Oct 6, 2023"
246,core/src/test/scala/unit/kafka/log/LogManagerTest.scala,28,2,30 ,"Oct 6, 2023"
247,core/src/test/scala/unit/kafka/server/KafkaRaftServerTest.scala,1,1,2 ,"Oct 6, 2023"
248,core/src/test/scala/unit/kafka/server/ServerGenerateBrokerIdTest.scala,2,3,5 ,"Oct 6, 2023"
249,core/src/test/scala/unit/kafka/server/ServerGenerateClusterIdTest.scala,2,3,5 ,"Oct 6, 2023"
250,clients/src/main/resources/common/message/ConsumerGroupHeartbeatRequest.json,0,15,15 ,"Oct 2, 2023"
251,clients/src/main/resources/common/message/ConsumerGroupHeartbeatResponse.json,2,12,14 ,"Oct 2, 2023"
252,clients/src/test/java/org/apache/kafka/clients/consumer/internals/MembershipManagerImplTest.java,1,1,2 ,"Oct 2, 2023"
253,clients/src/test/java/org/apache/kafka/common/protocol/ProtoUtilsTest.java,0,1,1,"Oct 2, 2023"
254,clients/src/test/java/org/apache/kafka/common/requests/RequestResponseTest.java,1,2,3 ,"Oct 2, 2023"
255,core/src/test/scala/unit/kafka/server/ConsumerGroupHeartbeatRequestTest.scala,1,1,2 ,"Oct 2, 2023"
256,group-coordinator/src/main/java/org/apache/kafka/coordinator/group/GroupMetadataManager.java,2,9,11 ,"Oct 2, 2023"
257,build.gradle,1,1,2 ,"Sep 29, 2023"
258,checkstyle/suppressions.xml,1,1,2 ,"Oct 2, 2023"
259,streams/src/main/java/org/apache/kafka/streams/processor/internals/StreamTask.java,7,2,9 ,"Oct 2, 2023"
260,streams/src/main/java/org/apache/kafka/streams/processor/internals/tasks/DefaultTaskExecutor.java,69,21,90 ,"Oct 2, 2023"
261,streams/src/main/java/org/apache/kafka/streams/processor/internals/tasks/DefaultTaskManager.java,54,12,66 ,"Oct 2, 2023"
262,LICENSE-binary,1,1,2 ,"Oct 3, 2023"
263,gradle/dependencies.gradle,1,1,2 ,"Oct 3, 2023"
264,checkstyle/suppressions.xml,2,2,4 ,"Oct 4, 2023"
265,clients/src/main/java/org/apache/kafka/common/requests/DeleteGroupsRequest.java,18,14,32 ,"Oct 4, 2023"
266,clients/src/test/java/org/apache/kafka/common/requests/DeleteGroupsRequestTest.java,49,0,49 ,"Oct 4, 2023"
267,group-coordinator/src/main/java/org/apache/kafka/coordinator/group/Group.java,27,0,27 ,"Oct 4, 2023"
268,group-coordinator/src/main/java/org/apache/kafka/coordinator/group/GroupCoordinatorService.java,88,37,125 ,"Oct 4, 2023"
269,.asf.yaml,14,14,28 ,"Oct 4, 2023"
270,core/src/main/scala/kafka/zk/ZkMigrationClient.scala,1,1,2 ,"Oct 6, 2023"
271,core/src/test/scala/integration/kafka/zk/ZkMigrationIntegrationTest.scala,31,28,59 ,"Oct 6, 2023"
272,core/src/test/scala/unit/kafka/zk/migration/ZkMigrationClientTest.scala,24,20,44 ,"Oct 6, 2023"
273,build.gradle,1,0,1,"Oct 2, 2023"
274,checkstyle/import-control.xml,4,0,4 ,"Oct 2, 2023"
275,core/src/test/java/kafka/test/ClusterConfig.java,5,0,5 ,"Oct 2, 2023"
276,core/src/test/scala/integration/kafka/admin/ReassignPartitionsIntegrationTest.scala,0,740,740 ,"Oct 2, 2023"
277,tools/src/main/java/org/apache/kafka/tools/reassign/VerifyAssignmentResult.java,1,1,2 ,"Oct 2, 2023"
278,tools/src/test/java/org/apache/kafka/tools/ToolsTestUtils.java,4,0,4 ,"Oct 2, 2023"
279,tools/src/test/java/org/apache/kafka/tools/reassign/ReassignPartitionsIntegrationTest.java,924,0,924 ,"Oct 2, 2023"
280,clients/src/main/java/org/apache/kafka/common/requests/ConsumerGroupHeartbeatRequest.java,5,0,5 ,"Oct 4, 2023"
281,group-coordinator/src/main/java/org/apache/kafka/coordinator/group/GroupMetadataManager.java,8,8,16 ,"Oct 4, 2023"
282,group-coordinator/src/test/java/org/apache/kafka/coordinator/group/GroupMetadataManagerTest.java,5,4,9 ,"Oct 4, 2023"
283,docs/ops.html,10,0,10 ,"Oct 4, 2023"
284,bin/kafka-leader-election.sh,1,1,2 ,"Oct 3, 2023"
285,bin/windows/kafka-leader-election.bat,1,1,2 ,"Oct 3, 2023"
286,build.gradle,4,4,8 ,"Oct 3, 2023"
287,core/src/main/scala/kafka/admin/LeaderElectionCommand.scala,0,289,289 ,"Oct 3, 2023"
288,streams/src/main/java/org/apache/kafka/streams/StreamsConfig.java,4,0,4 ,"Oct 4, 2023"
289,streams/src/main/java/org/apache/kafka/streams/processor/internals/ReadOnlyTask.java,1,1,2 ,"Oct 4, 2023"
290,streams/src/main/java/org/apache/kafka/streams/processor/internals/StoreChangelogReader.java,1,2,3 ,"Oct 4, 2023"
291,streams/src/main/java/org/apache/kafka/streams/processor/internals/StreamThread.java,4,5,9 ,"Oct 4, 2023"
292,streams/src/main/java/org/apache/kafka/streams/processor/internals/TaskExecutor.java,1,1,2 ,"Oct 4, 2023"
293,streams/src/main/java/org/apache/kafka/streams/processor/internals/TaskManager.java,45,12,57 ,"Oct 4, 2023"
294,streams/src/test/java/org/apache/kafka/streams/integration/EosV2UpgradeIntegrationTest.java,1,2,3 ,"Oct 4, 2023"
295,streams/src/test/java/org/apache/kafka/streams/integration/KTableKTableForeignKeyInnerJoinCustomPartitionerIntegrationTest.java,3,2,5 ,"Oct 4, 2023"
296,streams/src/test/java/org/apache/kafka/streams/integration/LagFetchIntegrationTest.java,11,6,17 ,"Oct 4, 2023"
297,clients/src/main/java/org/apache/kafka/clients/admin/KafkaAdminClient.java,2,3,5 ,"Oct 11, 2023"
298,clients/src/test/java/org/apache/kafka/clients/admin/KafkaAdminClientTest.java,12,0,12 ,"Oct 11, 2023"
299,core/src/test/scala/integration/kafka/api/PlaintextAdminIntegrationTest.scala,2,2,4 ,"Oct 11, 2023"
300,checkstyle/suppressions.xml,1,1,2 ,"Oct 5, 2023"
301,clients/src/main/java/org/apache/kafka/clients/producer/internals/ProducerBatch.java,49,0,49 ,"Oct 5, 2023"
302,clients/src/main/java/org/apache/kafka/clients/producer/internals/RecordAccumulator.java,39,16,55 ,"Oct 5, 2023"
303,clients/src/main/java/org/apache/kafka/clients/producer/internals/Sender.java,2,4,6 ,"Oct 5, 2023"
304,clients/src/test/java/org/apache/kafka/clients/producer/internals/ProducerBatchTest.java,51,0,51 ,"Oct 5, 2023"
305,tests/docker/Dockerfile,6,6,12 ,"Oct 5, 2023"
306,tests/kafkatest/version.py,8,7,15 ,"Oct 5, 2023"
307,clients/src/main/java/org/apache/kafka/common/requests/DescribeGroupsRequest.java,14,0,14 ,"Oct 6, 2023"
308,clients/src/test/java/org/apache/kafka/common/requests/DescribeGroupsRequestTest.java,52,0,52 ,"Oct 6, 2023"
309,group-coordinator/src/main/java/org/apache/kafka/coordinator/group/GroupCoordinatorService.java,48,4,52 ,"Oct 6, 2023"
310,group-coordinator/src/main/java/org/apache/kafka/coordinator/group/GroupCoordinatorShard.java,18,0,18 ,"Oct 6, 2023"
311,group-coordinator/src/main/java/org/apache/kafka/coordinator/group/GroupMetadataManager.java,79,0,79 ,"Oct 6, 2023"
312,group-coordinator/src/main/java/org/apache/kafka/coordinator/group/generic/GenericGroupMember.java,20,0,20 ,"Oct 6, 2023"
313,connect/mirror/src/test/java/org/apache/kafka/connect/mirror/MirrorMakerConfigTest.java,8,4,12 ,"Oct 5, 2023"
314,gradle/dependencies.gradle,2,0,2 ,"Oct 7, 2023"
315,tests/docker/Dockerfile,2,0,2 ,"Oct 7, 2023"
316,vagrant/base.sh,2,1,3 ,"Oct 7, 2023"
317,group-coordinator/src/main/java/org/apache/kafka/coordinator/group/GroupMetadataManager.java,1,5,6 ,"Oct 2, 2023"
318,clients/src/main/java/org/apache/kafka/clients/consumer/internals/AssignorSelection.java,9,5,14 ,"Oct 9, 2023"
319,clients/src/main/java/org/apache/kafka/clients/consumer/internals/DefaultBackgroundThread.java,39,25,64 ,"Oct 9, 2023"
320,streams/src/main/java/org/apache/kafka/streams/processor/internals/StreamsPartitionAssignor.java,1,1,2 ,"Oct 2, 2023"
321,core/src/test/scala/integration/kafka/admin/ListOffsetsIntegrationTest.scala,15,10,25 ,"Oct 9, 2023"
322,core/src/test/scala/integration/kafka/api/LogAppendTimeTest.scala,7,4,11 ,"Oct 9, 2023"
323,core/src/test/scala/integration/kafka/api/ProducerFailureHandlingTest.scala,44,30,74 ,"Oct 9, 2023"
324,core/src/test/scala/unit/kafka/integration/MetricsDuringTopicCreationDeletionTest.scala,8,6,14 ,"Oct 9, 2023"
325,core/src/test/scala/unit/kafka/server/FetchRequestMaxBytesTest.scala,7,4,11 ,"Oct 9, 2023"
326,clients/src/main/java/org/apache/kafka/common/security/ssl/SslPrincipalMapper.java,1,1,2 ,"Sep 29, 2023"
327,core/src/main/scala/kafka/admin/ConfigCommand.scala,11,2,13 ,"Oct 10, 2023"
328,core/src/test/scala/unit/kafka/admin/ConfigCommandTest.scala,18,2,20 ,"Oct 10, 2023"
329,core/src/test/scala/unit/kafka/log/remote/RemoteIndexCacheTest.scala,258,17,275 ,"Oct 11, 2023"
330,storage/src/main/java/org/apache/kafka/storage/internals/log/RemoteIndexCache.java,2,2,4 ,"Oct 11, 2023"
331,streams/src/main/java/org/apache/kafka/streams/processor/internals/assignment/RackAwareTaskAssignor.java,8,3,11 ,"Sep 29, 2023"
332,build.gradle,3,0,3 ,"Oct 2, 2023"
333,gradle/resources/dependencycheck-suppressions.xml,26,0,26 ,"Oct 2, 2023"
334,core/src/main/java/kafka/log/remote/RemoteLogManager.java,5,1,6 ,"Oct 8, 2023"
335,core/src/main/scala/kafka/server/DynamicBrokerConfig.scala,51,1,52 ,"Oct 8, 2023"
336,core/src/test/scala/unit/kafka/log/remote/RemoteIndexCacheTest.scala,85,22,107 ,"Oct 8, 2023"
337,core/src/test/scala/unit/kafka/server/DynamicBrokerConfigTest.scala,26,0,26 ,"Oct 8, 2023"
338,storage/src/main/java/org/apache/kafka/server/log/remote/storage/RemoteLogManagerConfig.java,1,1,2 ,"Oct 8, 2023"
339,clients/src/main/java/org/apache/kafka/common/requests/OffsetCommitResponse.java,2,0,2 ,"Oct 2, 2023"
340,clients/src/main/java/org/apache/kafka/common/requests/ProduceResponse.java,2,0,2 ,"Oct 2, 2023"
341,core/src/main/scala/kafka/coordinator/group/GroupCoordinator.scala,4,2,6 ,"Oct 2, 2023"
342,core/src/main/scala/kafka/coordinator/group/GroupCoordinatorAdapter.scala,1,0,1,"Oct 2, 2023"
343,core/src/main/scala/kafka/coordinator/group/GroupMetadataManager.scala,6,3,9 ,"Oct 2, 2023"
344,core/src/main/scala/kafka/log/UnifiedLog.scala,4,2,6 ,"Oct 2, 2023"
345,core/src/test/scala/unit/kafka/coordinator/group/GroupCoordinatorAdapterTest.scala,1,0,1,"Oct 2, 2023"
346,core/src/test/scala/unit/kafka/coordinator/group/GroupCoordinatorConcurrencyTest.scala,2,1,3 ,"Oct 2, 2023"
347,core/src/test/scala/unit/kafka/coordinator/group/GroupCoordinatorTest.scala,4,2,6 ,"Oct 2, 2023"
348,core/src/test/scala/unit/kafka/coordinator/group/GroupMetadataManagerTest.scala,64,5,69 ,"Oct 2, 2023"
349,core/src/test/scala/unit/kafka/log/UnifiedLogTest.scala,19,9,28 ,"Oct 2, 2023"
350,build.gradle,1,1,2 ,"Oct 3, 2023"
351,metadata/src/test/java/org/apache/kafka/controller/QuorumControllerTest.java,78,4,82 ,"Sep 22, 2023"
352,metadata/src/test/java/org/apache/kafka/metadata/RecordTestUtils.java,30,0,30 ,"Sep 22, 2023"
353,core/src/main/java/kafka/log/remote/RemoteLogManager.java,46,44,90 ,"Sep 25, 2023"
354,core/src/test/scala/unit/kafka/log/remote/RemoteIndexCacheTest.scala,27,1,28 ,"Sep 29, 2023"
355,storage/src/main/java/org/apache/kafka/storage/internals/log/RemoteIndexCache.java,1,2,3 ,"Sep 29, 2023"
356,build.gradle,9,12,21 ,"Sep 24, 2023"
357,gradle/dependencies.gradle,24,11,35 ,"Sep 24, 2023"
358,gradle/wrapper/gradle-wrapper.properties,3,2,5 ,"Sep 24, 2023"
359,gradlew,5,2,7 ,"Sep 24, 2023"
360,connect/runtime/src/main/java/org/apache/kafka/connect/converters/BooleanConverter.java,112,0,112 ,"Sep 26, 2023"
361,connect/runtime/src/main/java/org/apache/kafka/connect/converters/BooleanConverterConfig.java,37,0,37 ,"Sep 26, 2023"
362,connect/runtime/src/main/resources/META-INF/services/org.apache.kafka.connect.storage.Converter,1,0,1,"Sep 26, 2023"
363,connect/runtime/src/main/resources/META-INF/services/org.apache.kafka.connect.storage.HeaderConverter,1,0,1,"Sep 26, 2023"
364,connect/runtime/src/test/java/org/apache/kafka/connect/converters/BooleanConverterTest.java,114,0,114 ,"Sep 26, 2023"
365,tests/kafkatest/tests/core/kraft_upgrade_test.py,3,3,6 ,"Sep 23, 2023"
366,core/src/main/scala/kafka/server/AbstractFetcherThread.scala,3,2,5 ,"Sep 28, 2023"
367,core/src/test/scala/unit/kafka/server/ReplicaFetcherThreadTest.scala,3,1,4 ,"Sep 28, 2023"
368,clients/src/main/java/org/apache/kafka/common/security/ssl/SslFactory.java,36,22,58 ,"Sep 26, 2023"
369,clients/src/test/java/org/apache/kafka/common/security/ssl/SslFactoryTest.java,22,7,29 ,"Sep 26, 2023"
370,clients/src/test/java/org/apache/kafka/test/TestSslUtils.java,83,0,83 ,"Sep 26, 2023"
371,clients/src/test/java/org/apache/kafka/common/utils/LogCaptureAppender.java,22,2,24 ,"Sep 26, 2023"
372,connect/mirror/src/test/java/org/apache/kafka/connect/mirror/MirrorSourceConnectorTest.java,1,1,2 ,"Sep 26, 2023"
373,connect/runtime/src/test/java/org/apache/kafka/connect/runtime/SourceTaskOffsetCommitterTest.java,1,1,2 ,"Sep 26, 2023"
374,connect/runtime/src/test/java/org/apache/kafka/connect/runtime/WorkerSourceTaskTest.java,2,2,4 ,"Sep 26, 2023"
375,streams/src/test/java/org/apache/kafka/streams/StreamsConfigTest.java,3,3,6 ,"Sep 26, 2023"
376,streams/src/test/java/org/apache/kafka/streams/processor/internals/InternalTopicManagerTest.java,1,1,2 ,"Sep 26, 2023"
377,streams/src/test/java/org/apache/kafka/streams/processor/internals/PartitionGroupTest.java,7,7,14 ,"Sep 26, 2023"
378,streams/src/test/java/org/apache/kafka/streams/processor/internals/StoreChangelogReaderTest.java,1,1,2 ,"Sep 26, 2023"
379,streams/src/test/java/org/apache/kafka/streams/processor/internals/TaskManagerTest.java,1,1,2 ,"Sep 26, 2023"
380,streams/src/main/java/org/apache/kafka/streams/processor/internals/TaskManager.java,14,9,23 ,"Sep 26, 2023"
381,streams/src/test/java/org/apache/kafka/streams/processor/internals/TaskManagerTest.java,42,3,45 ,"Sep 26, 2023"
382,clients/src/main/java/org/apache/kafka/clients/consumer/internals/AbstractCoordinator.java,4,1,5 ,"Sep 29, 2023"
383,clients/src/test/java/org/apache/kafka/common/network/SslTransportLayerTest.java,0,3,3 ,"Sep 25, 2023"
384,clients/src/test/java/org/apache/kafka/test/TestSslUtils.java,8,4,12 ,"Sep 25, 2023"
385,metadata/src/main/java/org/apache/kafka/controller/BrokersToIsrs.java,1,0,1,"Sep 28, 2023"
386,metadata/src/main/java/org/apache/kafka/controller/ReplicationControlManager.java,1,0,1,"Sep 28, 2023"
387,metadata/src/test/java/org/apache/kafka/controller/BrokersToIsrsTest.java,1,0,1,"Sep 28, 2023"
388,metadata/src/test/java/org/apache/kafka/controller/QuorumControllerTest.java,1,0,1,"Sep 28, 2023"
389,metadata/src/test/java/org/apache/kafka/controller/ReplicationControlManagerTest.java,1,0,1,"Sep 28, 2023"
390,checkstyle/import-control-core.xml,2,1,3 ,"Sep 26, 2023"
391,checkstyle/import-control-server-common.xml,2,0,2 ,"Sep 26, 2023"
392,clients/src/main/java/org/apache/kafka/clients/NetworkClient.java,1,1,2 ,"Sep 26, 2023"
393,clients/src/main/java/org/apache/kafka/clients/NodeApiVersions.java,2,2,4 ,"Sep 26, 2023"
394,clients/src/main/java/org/apache/kafka/clients/admin/AdminClientConfig.java,14,1,15 ,"Sep 26, 2023"
395,clients/src/main/java/org/apache/kafka/clients/admin/FinalizedVersionRange.java,1,1,2 ,"Sep 26, 2023"
396,streams/src/main/java/org/apache/kafka/streams/processor/internals/DefaultStateUpdater.java,12,2,14 ,"Sep 26, 2023"
397,streams/src/main/java/org/apache/kafka/streams/processor/internals/StoreChangelogReader.java,4,4,8 ,"Sep 26, 2023"
398,streams/src/test/java/org/apache/kafka/streams/processor/internals/DefaultStateUpdaterTest.java,26,0,26 ,"Sep 26, 2023"
399,streams/src/main/java/org/apache/kafka/streams/processor/internals/PartitionGroup.java,24,4,28 ,"Sep 26, 2023"
400,streams/src/main/java/org/apache/kafka/streams/processor/internals/ReadOnlyTask.java,10,0,10 ,"Sep 26, 2023"
401,streams/src/main/java/org/apache/kafka/streams/processor/internals/StandbyTask.java,10,0,10 ,"Sep 26, 2023"
402,streams/src/main/java/org/apache/kafka/streams/processor/internals/StreamTask.java,19,1,20 ,"Sep 26, 2023"
403,streams/src/main/java/org/apache/kafka/streams/processor/internals/StreamThread.java,7,1,8 ,"Sep 26, 2023"
404,streams/src/main/java/org/apache/kafka/streams/processor/internals/Task.java,11,0,11 ,"Sep 26, 2023"
405,streams/src/main/java/org/apache/kafka/streams/processor/internals/TaskManager.java,19,4,23 ,"Sep 26, 2023"
406,streams/src/test/java/org/apache/kafka/streams/integration/PauseResumeIntegrationTest.java,2,2,4 ,"Sep 26, 2023"
407,streams/src/test/java/org/apache/kafka/streams/integration/utils/IntegrationTestUtils.java,1,1,2 ,"Sep 26, 2023"
408,streams/src/test/java/org/apache/kafka/streams/processor/internals/PartitionGroupTest.java,86,1,87 ,"Sep 26, 2023"
409,LICENSE-binary,2,2,4 ,"Sep 24, 2023"
410,bin/kafka-run-class.sh,1,1,2 ,"Sep 24, 2023"
411,bin/windows/kafka-run-class.bat,1,1,2 ,"Sep 24, 2023"
412,checkstyle/.scalafmt.conf,2,2,4 ,"Sep 24, 2023"
413,core/src/main/scala/kafka/log/LogCleaner.scala,2,2,4 ,"Sep 24, 2023"
414,core/src/test/scala/other/kafka/ReplicationQuotasTestRig.scala,3,4,7 ,"Sep 24, 2023"
415,core/src/test/scala/unit/kafka/log/LogLoaderTest.scala,2,2,4 ,"Sep 24, 2023"
416,core/src/test/scala/unit/kafka/log/TimeIndexTest.scala,1,1,2 ,"Sep 24, 2023"
417,core/src/test/scala/unit/kafka/network/SocketServerTest.scala,2,2,4 ,"Sep 24, 2023"
418,core/src/test/scala/unit/kafka/server/ReplicaManagerTest.scala,6,6,12 ,"Sep 24, 2023"
419,gradle.properties,1,1,2 ,"Sep 24, 2023"
420,gradle/dependencies.gradle,2,2,4 ,"Sep 24, 2023"
421,checkstyle/import-control.xml,2,0,2 ,"Sep 23, 2023"
422,core/src/main/scala/kafka/admin/ReassignPartitionsCommand.scala,7,7,14 ,"Sep 23, 2023"
423,core/src/main/java/kafka/log/remote/RemoteLogManager.java,4,2,6 ,"Sep 21, 2023"
424,core/src/test/java/kafka/log/remote/RemoteLogManagerTest.java,152,0,152 ,"Sep 21, 2023"
425,streams/src/main/java/org/apache/kafka/streams/processor/internals/StreamThread.java,7,1,8 ,"Sep 26, 2023"
426,streams/src/test/java/org/apache/kafka/streams/processor/internals/StreamThreadTest.java,89,0,89 ,"Sep 26, 2023"
427,storage/src/main/java/org/apache/kafka/server/log/remote/metadata/storage/TopicBasedRemoteLogMetadataManager.java,1,2,3 ,"Sep 21, 2023"
428,streams/src/test/java/org/apache/kafka/streams/integration/KStreamRepartitionIntegrationTest.java,5,5,10 ,"Sep 21, 2023"
429,streams/src/test/java/org/apache/kafka/streams/integration/StreamTableJoinTopologyOptimizationIntegrationTest.java,4,4,8 ,"Sep 21, 2023"
430,group-coordinator/src/main/java/org/apache/kafka/coordinator/group/runtime/CoordinatorRuntime.java,1,1,2 ,"Sep 28, 2023"
431,Jenkinsfile,3,3,6 ,"Sep 25, 2023"
432,build.gradle,12,6,18 ,"Sep 25, 2023"
433,clients/src/test/java/org/apache/kafka/common/network/SslTransportLayerTest.java,1,1,2 ,"Sep 25, 2023"
434,streams/src/main/java/org/apache/kafka/streams/processor/internals/TaskManager.java,2,1,3 ,"Sep 27, 2023"
435,streams/src/test/java/org/apache/kafka/streams/processor/internals/TaskManagerTest.java,42,0,42 ,"Sep 27, 2023"
436,core/src/main/scala/kafka/log/UnifiedLog.scala,2,2,4 ,"Sep 29, 2023"
437,core/src/test/scala/unit/kafka/log/LogLoaderTest.scala,8,2,10 ,"Sep 29, 2023"
438,core/src/test/scala/unit/kafka/log/UnifiedLogTest.scala,5,1,6 ,"Sep 29, 2023"
439,core/src/test/scala/unit/kafka/tools/DumpLogSegmentsTest.scala,2,2,4 ,"Sep 29, 2023"
440,clients/src/main/java/org/apache/kafka/clients/consumer/internals/CommitRequestManager.java,32,41,73 ,"Sep 21, 2023"
441,clients/src/main/java/org/apache/kafka/clients/consumer/internals/CoordinatorRequestManager.java,3,3,6 ,"Sep 21, 2023"
442,clients/src/main/java/org/apache/kafka/clients/consumer/internals/DefaultBackgroundThread.java,15,11,26 ,"Sep 21, 2023"
443,clients/src/main/java/org/apache/kafka/clients/consumer/internals/NetworkClientDelegate.java,10,12,22 ,"Sep 21, 2023"
444,clients/src/main/java/org/apache/kafka/clients/consumer/internals/OffsetsRequestManager.java,1,1,2 ,"Sep 21, 2023"
445,clients/src/main/java/org/apache/kafka/clients/consumer/internals/PrototypeAsyncConsumer.java,0,1,1,"Sep 21, 2023"
446,clients/src/main/java/org/apache/kafka/clients/consumer/internals/RequestManagers.java,4,0,4 ,"Sep 21, 2023"
447,streams/src/main/java/org/apache/kafka/streams/StreamsConfig.java,1,1,2 ,"Sep 21, 2023"
448,LICENSE-binary,1,1,2 ,"Sep 27, 2023"
449,core/src/test/scala/integration/kafka/api/ProducerCompressionTest.scala,54,9,63 ,"Sep 27, 2023"
450,core/src/test/scala/unit/kafka/log/LogCleanerParameterizedIntegrationTest.scala,2,2,4 ,"Sep 27, 2023"
451,gradle/dependencies.gradle,1,1,2 ,"Sep 27, 2023"
452,README.md,1,1,2 ,"Sep 26, 2023"
453,core/src/main/scala/kafka/server/AddPartitionsToTxnManager.scala,80,9,89 ,"Sep 25, 2023"
454,core/src/main/scala/kafka/server/BrokerServer.scala,10,3,13 ,"Sep 25, 2023"
455,core/src/main/scala/kafka/server/KafkaApis.scala,2,8,10 ,"Sep 25, 2023"
456,core/src/main/scala/kafka/server/KafkaRequestHandler.scala,9,7,16 ,"Sep 25, 2023"
457,core/src/main/scala/kafka/server/KafkaServer.scala,10,2,12 ,"Sep 25, 2023"
458,core/src/main/scala/kafka/server/ReplicaManager.scala,10,59,69 ,"Sep 25, 2023"
459,core/src/test/scala/kafka/server/KafkaRequestHandlerTest.scala,14,11,25 ,"Sep 25, 2023"
460,clients/src/main/java/org/apache/kafka/clients/consumer/internals/AbstractCoordinator.java,1,1,2 ,"Sep 24, 2023"
461,clients/src/main/java/org/apache/kafka/clients/consumer/internals/DefaultBackgroundThread.java,2,2,4 ,"Sep 24, 2023"
462,clients/src/main/java/org/apache/kafka/clients/consumer/internals/MembershipManagerImpl.java,1,1,2 ,"Sep 24, 2023"
463,clients/src/main/java/org/apache/kafka/clients/consumer/internals/OffsetsRequestManager.java,2,1,3 ,"Sep 24, 2023"
464,clients/src/main/java/org/apache/kafka/clients/producer/KafkaProducer.java,1,1,2 ,"Sep 24, 2023"
465,clients/src/main/java/org/apache/kafka/common/config/AbstractConfig.java,1,1,2 ,"Sep 24, 2023"
466,clients/src/main/java/org/apache/kafka/common/config/ConfigDef.java,3,2,5 ,"Sep 24, 2023"
467,clients/src/main/java/org/apache/kafka/common/metrics/Metrics.java,1,0,1,"Sep 24, 2023"
468,clients/src/main/java/org/apache/kafka/common/protocol/types/Schema.java,1,0,1,"Sep 24, 2023"
469,clients/src/main/java/org/apache/kafka/common/record/LazyDownConversionRecords.java,1,1,2 ,"Sep 24, 2023"
470,clients/src/main/java/org/apache/kafka/common/record/MemoryRecordsBuilder.java,1,1,2 ,"Sep 24, 2023"
471,clients/src/main/java/org/apache/kafka/common/requests/DeleteAclsResponse.java,1,1,2 ,"Sep 24, 2023"
472,clients/src/main/java/org/apache/kafka/common/requests/DescribeAclsResponse.java,1,1,2 ,"Sep 24, 2023"
473,clients/src/main/java/org/apache/kafka/common/security/authenticator/SaslClientAuthenticator.java,1,0,1,"Sep 24, 2023"
474,clients/src/main/java/org/apache/kafka/common/security/oauthbearer/internals/OAuthBearerSaslClientProvider.java,1,0,1,"Sep 24, 2023"
475,clients/src/main/java/org/apache/kafka/common/security/oauthbearer/internals/OAuthBearerSaslServerProvider.java,1,0,1,"Sep 24, 2023"
476,clients/src/main/java/org/apache/kafka/common/security/oauthbearer/internals/unsecured/OAuthBearerUnsecuredJws.java,8,8,16 ,"Sep 24, 2023"
477,clients/src/main/java/org/apache/kafka/common/security/plain/internals/PlainSaslServerProvider.java,1,1,2 ,"Sep 24, 2023"
478,clients/src/main/java/org/apache/kafka/common/security/scram/internals/ScramSaslClientProvider.java,1,1,2 ,"Sep 24, 2023"
479,clients/src/main/java/org/apache/kafka/common/security/scram/internals/ScramSaslServerProvider.java,1,1,2 ,"Sep 24, 2023"
480,clients/src/main/java/org/apache/kafka/common/utils/ImplicitLinkedHashCollection.java,1,0,1,"Sep 24, 2023"
481,clients/src/main/java/org/apache/kafka/common/utils/KafkaThread.java,2,0,2 ,"Sep 24, 2023"
482,clients/src/main/java/org/apache/kafka/common/utils/PureJavaCrc32C.java,1,1,2 ,"Sep 24, 2023"
483,clients/src/test/java/org/apache/kafka/clients/admin/MockAdminClient.java,3,1,4 ,"Sep 24, 2023"
484,clients/src/test/java/org/apache/kafka/common/network/NioEchoServer.java,1,0,1,"Sep 24, 2023"
485,clients/src/test/java/org/apache/kafka/common/network/PlaintextSender.java,1,0,1,"Sep 24, 2023"
486,clients/src/test/java/org/apache/kafka/common/network/SslSender.java,1,0,1,"Sep 24, 2023"
487,clients/src/test/java/org/apache/kafka/common/security/ssl/DefaultSslEngineFactoryTest.java,1,0,1,"Sep 24, 2023"
488,clients/src/test/java/org/apache/kafka/common/security/ssl/mock/TestProvider.java,1,0,1,"Sep 24, 2023"
489,clients/src/test/java/org/apache/kafka/common/utils/MockScheduler.java,1,0,1,"Sep 24, 2023"
490,connect/json/src/main/java/org/apache/kafka/connect/json/JsonConverterConfig.java,1,0,1,"Sep 24, 2023"
491,connect/mirror/src/main/java/org/apache/kafka/connect/mirror/MirrorConnectorConfig.java,1,0,1,"Sep 24, 2023"
492,connect/mirror/src/main/java/org/apache/kafka/connect/mirror/MirrorMakerConfig.java,1,0,1,"Sep 24, 2023"
493,connect/runtime/src/main/java/org/apache/kafka/connect/runtime/SourceConnectorConfig.java,1,0,1,"Sep 24, 2023"
494,connect/runtime/src/main/java/org/apache/kafka/connect/runtime/Worker.java,1,0,1,"Sep 24, 2023"
495,clients/src/main/resources/common/message/ConsumerGroupDescribeResponse.json,1,1,2 ,"Sep 28, 2023"
496,storage/src/test/java/org/apache/kafka/server/log/remote/storage/LocalTieredStorageTest.java,1,10,11 ,"Sep 28, 2023"
497,storage/src/test/java/org/apache/kafka/tiered/storage/utils/BrokerLocalStorage.java,44,7,51 ,"Sep 28, 2023"
498,clients/src/main/java/org/apache/kafka/common/config/TopicConfig.java,1,1,2 ,"Sep 13, 2023"
499,storage/api/src/main/java/org/apache/kafka/server/log/remote/storage/RemoteLogMetadataManager.java,5,6,11 ,"Sep 13, 2023"
500,storage/api/src/main/java/org/apache/kafka/server/log/remote/storage/RemoteStorageManager.java,4,0,4 ,"Sep 13, 2023"
501,storage/src/main/java/org/apache/kafka/server/log/remote/storage/RemoteLogManagerConfig.java,3,3,6 ,"Sep 13, 2023"
502,streams/src/test/java/org/apache/kafka/streams/state/internals/KeyValueIteratorFacadeTest.java,9,20,29 ,"Sep 19, 2023"
503,streams/src/test/java/org/apache/kafka/streams/state/internals/KeyValueSegmentTest.java,7,6,13 ,"Sep 19, 2023"
504,core/src/test/scala/integration/kafka/api/TransactionsTest.scala,57,5,62 ,"Sep 19, 2023"
505,storage/src/test/java/org/apache/kafka/tiered/storage/integration/TransactionsWithTieredStoreTest.java,19,1,20 ,"Sep 19, 2023"
506,connect/runtime/src/main/java/org/apache/kafka/connect/runtime/rest/resources/ConnectorPluginsResource.java,5,3,8 ,"Sep 19, 2023"
507,connect/runtime/src/test/java/org/apache/kafka/connect/runtime/rest/resources/ConnectorPluginsResourceTest.java,18,3,21 ,"Sep 19, 2023"
508,docs/ops.html,2,1,3 ,"Sep 12, 2023"
509,clients/src/main/java/org/apache/kafka/clients/admin/TransactionState.java,1,2,3 ,"Sep 11, 2023"
510,storage/src/main/java/org/apache/kafka/server/log/remote/storage/RemoteLogManagerConfig.java,2,2,4 ,"Sep 9, 2023"
511,storage/src/test/java/org/apache/kafka/server/log/remote/storage/LocalTieredStorage.java,4,0,4 ,"Sep 9, 2023"
512,storage/src/test/java/org/apache/kafka/tiered/storage/TieredStorageTestContext.java,9,2,11 ,"Sep 9, 2023"
513,checkstyle/suppressions.xml,1,1,2 ,"Sep 15, 2023"
514,group-coordinator/src/main/java/org/apache/kafka/coordinator/group/Group.java,11,0,11 ,"Sep 15, 2023"
515,group-coordinator/src/main/java/org/apache/kafka/coordinator/group/GroupCoordinatorService.java,31,3,34 ,"Sep 15, 2023"
516,group-coordinator/src/main/java/org/apache/kafka/coordinator/group/GroupCoordinatorShard.java,17,0,17 ,"Sep 15, 2023"
517,group-coordinator/src/main/java/org/apache/kafka/coordinator/group/GroupMetadataManager.java,20,0,20 ,"Sep 15, 2023"
518,group-coordinator/src/main/java/org/apache/kafka/coordinator/group/consumer/ConsumerGroup.java,26,0,26 ,"Sep 15, 2023"
519,group-coordinator/src/main/java/org/apache/kafka/coordinator/group/generic/GenericGroup.java,12,2,14 ,"Sep 15, 2023"
520,core/src/main/scala/kafka/admin/AclCommand.scala,1,1,2 ,"Sep 19, 2023"
521,docs/ops.html,92,0,92 ,"Sep 14, 2023"
522,docs/toc.html,8,0,8 ,"Sep 14, 2023"
523,docs/upgrade.html,5,0,5 ,"Sep 14, 2023"
524,core/src/test/scala/integration/kafka/zk/ZkMigrationIntegrationTest.scala,24,9,33 ,"Sep 8, 2023"
525,metadata/src/main/java/org/apache/kafka/controller/QuorumController.java,20,21,41 ,"Sep 8, 2023"
526,metadata/src/main/java/org/apache/kafka/metadata/migration/KRaftMigrationDriver.java,1,1,2 ,"Sep 8, 2023"
527,metadata/src/test/java/org/apache/kafka/controller/QuorumControllerTest.java,60,0,60 ,"Sep 8, 2023"
528,connect/runtime/src/test/java/org/apache/kafka/connect/integration/ConnectWorkerIntegrationTest.java,4,4,8 ,"Sep 19, 2023"
529,connect/runtime/src/test/java/org/apache/kafka/connect/integration/ConnectorTopicsIntegrationTest.java,4,4,8 ,"Sep 19, 2023"
530,connect/runtime/src/test/java/org/apache/kafka/connect/integration/ErrorHandlingIntegrationTest.java,4,4,8 ,"Sep 19, 2023"
531,connect/runtime/src/test/java/org/apache/kafka/connect/integration/RebalanceSourceConnectorsIntegrationTest.java,2,2,4 ,"Sep 19, 2023"
532,connect/runtime/src/test/java/org/apache/kafka/connect/util/clusters/EmbeddedConnectClusterAssertions.java,10,16,26 ,"Sep 19, 2023"
533,clients/src/main/java/org/apache/kafka/clients/consumer/LogTruncationException.java,5,0,5 ,"Sep 13, 2023"
534,clients/src/main/java/org/apache/kafka/clients/consumer/internals/DefaultBackgroundThread.java,9,1,10 ,"Sep 13, 2023"
535,clients/src/main/java/org/apache/kafka/clients/consumer/internals/OffsetFetcher.java,6,54,60 ,"Sep 13, 2023"
536,clients/src/main/java/org/apache/kafka/clients/consumer/internals/OffsetFetcherUtils.java,77,11,88 ,"Sep 13, 2023"
537,core/src/test/scala/unit/kafka/server/ControllerRegistrationManagerTest.scala,1,1,2 ,"Sep 20, 2023"
538,checkstyle/suppressions.xml,1,1,2 ,"Sep 16, 2023"
539,clients/src/main/java/org/apache/kafka/clients/NetworkClientUtils.java,8,0,8 ,"Sep 16, 2023"
540,clients/src/main/java/org/apache/kafka/clients/consumer/KafkaConsumer.java,11,1,12 ,"Sep 16, 2023"
541,clients/src/main/java/org/apache/kafka/clients/consumer/internals/AbstractFetch.java,106,411,517 ,"Sep 16, 2023"
542,clients/src/main/java/org/apache/kafka/clients/consumer/internals/CompletedFetch.java,19,21,40 ,"Sep 16, 2023"
543,clients/src/main/java/org/apache/kafka/clients/consumer/internals/ConsumerNetworkClient.java,1,1,2 ,"Sep 16, 2023"
544,clients/src/main/java/org/apache/kafka/clients/consumer/internals/ConsumerUtils.java,25,0,25 ,"Sep 16, 2023"
545,clients/src/main/java/org/apache/kafka/clients/consumer/internals/DefaultBackgroundThread.java,1,0,1,"Sep 16, 2023"
546,clients/src/main/java/org/apache/kafka/clients/consumer/internals/DefaultEventHandler.java,1,0,1,"Sep 16, 2023"
547,build.gradle,2,4,6 ,"Sep 19, 2023"
548,checkstyle/checkstyle.xml,3,3,6 ,"Sep 19, 2023"
549,core/src/main/scala/kafka/server/KafkaConfig.scala,1,0,1,"Sep 12, 2023"
550,core/src/test/scala/unit/kafka/server/KafkaConfigTest.scala,12,0,12 ,"Sep 12, 2023"
551,shell/src/main/java/org/apache/kafka/shell/MetadataShell.java,2,2,4 ,"Sep 11, 2023"
552,clients/src/main/java/org/apache/kafka/common/config/SslConfigs.java,6,1,7 ,"Sep 15, 2023"
553,clients/src/main/java/org/apache/kafka/common/security/ssl/CommonNameLoggingSslEngineFactory.java,36,0,36 ,"Sep 15, 2023"
554,clients/src/main/java/org/apache/kafka/common/security/ssl/CommonNameLoggingTrustManagerFactoryWrapper.java,424,0,424 ,"Sep 15, 2023"
555,clients/src/main/java/org/apache/kafka/common/security/ssl/DefaultSslEngineFactory.java,13,5,18 ,"Sep 15, 2023"
556,clients/src/test/java/org/apache/kafka/common/security/ssl/CommonNameLoggingSslEngineFactoryTest.java,25,0,25 ,"Sep 15, 2023"
557,core/src/main/scala/kafka/server/BrokerServer.scala,15,39,54 ,"Sep 20, 2023"
558,core/src/main/scala/kafka/server/ControllerRegistrationManager.scala,5,20,25 ,"Sep 20, 2023"
559,core/src/main/scala/kafka/server/ControllerServer.scala,19,28,47 ,"Sep 20, 2023"
560,core/src/test/scala/unit/kafka/server/ControllerRegistrationManagerTest.scala,4,3,7 ,"Sep 20, 2023"
561,clients/src/main/java/org/apache/kafka/common/requests/OffsetCommitRequest.java,6,2,8 ,"Sep 11, 2023"
562,clients/src/main/java/org/apache/kafka/common/requests/OffsetFetchRequest.java,37,41,78 ,"Sep 11, 2023"
563,clients/src/main/resources/common/message/OffsetFetchRequest.json,1,1,2 ,"Sep 11, 2023"
564,clients/src/test/java/org/apache/kafka/common/requests/OffsetFetchRequestTest.java,0,1,1,"Sep 11, 2023"
565,clients/src/test/java/org/apache/kafka/common/requests/RequestResponseTest.java,11,9,20 ,"Sep 11, 2023"
566,core/src/main/scala/kafka/server/KafkaApis.scala,2,0,2 ,"Sep 11, 2023"
567,core/src/test/java/kafka/test/junit/ZkClusterInvocationContext.java,1,1,2 ,"Sep 11, 2023"
568,clients/src/main/java/org/apache/kafka/common/utils/AppInfoParser.java,6,1,7 ,"Sep 14, 2023"
569,clients/src/test/java/org/apache/kafka/common/utils/AppInfoParserTest.java,14,0,14 ,"Sep 14, 2023"
570,clients/src/main/java/org/apache/kafka/clients/consumer/internals/ConsumerCoordinator.java,7,33,40 ,"Sep 18, 2023"
571,clients/src/main/java/org/apache/kafka/clients/consumer/internals/ConsumerUtils.java,55,0,55 ,"Sep 18, 2023"
572,clients/src/main/java/org/apache/kafka/clients/consumer/internals/PrototypeAsyncConsumer.java,48,3,51 ,"Sep 18, 2023"
573,streams/src/main/java/org/apache/kafka/streams/state/internals/RocksDBTimestampedStore.java,1,1,2 ,"Sep 18, 2023"
574,streams/src/main/java/org/apache/kafka/streams/state/internals/metrics/RocksDBMetricsRecorder.java,2,2,4 ,"Sep 18, 2023"
575,streams/src/test/java/org/apache/kafka/streams/state/internals/metrics/RocksDBBlockCacheMetricsTest.java,136,0,136 ,"Sep 18, 2023"
576,streams/src/test/java/org/apache/kafka/streams/state/internals/metrics/RocksDBMetricsRecorderGaugesTest.java,16,3,19 ,"Sep 18, 2023"
577,gradle/spotbugs-exclude.xml,6,0,6 ,"Sep 11, 2023"
578,streams/src/main/java/org/apache/kafka/streams/processor/internals/tasks/DefaultTaskExecutor.java,7,1,8 ,"Sep 11, 2023"
579,streams/src/main/java/org/apache/kafka/streams/processor/internals/tasks/DefaultTaskManager.java,48,5,53 ,"Sep 11, 2023"
580,streams/src/main/java/org/apache/kafka/streams/processor/internals/tasks/TaskManager.java,10,2,12 ,"Sep 11, 2023"
581,streams/src/test/java/org/apache/kafka/streams/processor/internals/tasks/DefaultTaskExecutorTest.java,10,0,10 ,"Sep 11, 2023"
582,streams/src/test/java/org/apache/kafka/streams/processor/internals/tasks/DefaultTaskManagerTest.java,120,3,123 ,"Sep 11, 2023"
583,core/src/main/scala/kafka/server/ReplicaManager.scala,1,0,1,"Sep 8, 2023"
584,core/src/test/scala/integration/kafka/api/TransactionsTest.scala,58,25,83 ,"Sep 14, 2023"
585,storage/src/test/java/org/apache/kafka/tiered/storage/TieredStorageTestHarness.java,8,81,89 ,"Sep 14, 2023"
586,storage/src/test/java/org/apache/kafka/tiered/storage/actions/ConsumeAction.java,1,1,2 ,"Sep 14, 2023"
587,storage/src/test/java/org/apache/kafka/tiered/storage/actions/CreateTopicAction.java,10,18,28 ,"Sep 14, 2023"
588,storage/src/test/java/org/apache/kafka/tiered/storage/actions/ExpectBrokerInISRAction.java,1,1,2 ,"Sep 14, 2023"
589,storage/src/test/java/org/apache/kafka/tiered/storage/actions/ExpectLeaderAction.java,1,1,2 ,"Sep 14, 2023"
590,core/src/main/scala/kafka/coordinator/transaction/ProducerIdManager.scala,3,3,6 ,"Sep 11, 2023"
591,core/src/main/scala/kafka/network/RequestChannel.scala,1,1,2 ,"Sep 11, 2023"
592,core/src/main/scala/kafka/raft/KafkaNetworkChannel.scala,1,1,2 ,"Sep 11, 2023"
593,core/src/main/scala/kafka/server/AlterPartitionManager.scala,3,3,6 ,"Sep 11, 2023"
594,core/src/main/scala/kafka/server/AutoTopicCreationManager.scala,2,2,4 ,"Sep 11, 2023"
595,core/src/main/scala/kafka/server/BrokerLifecycleManager.scala,4,4,8 ,"Sep 11, 2023"
596,core/src/main/scala/kafka/server/BrokerServer.scala,3,3,6 ,"Sep 11, 2023"
597,core/src/main/scala/kafka/server/ControllerRegistrationManager.scala,2,2,4 ,"Sep 11, 2023"
598,core/src/main/scala/kafka/server/ControllerServer.scala,2,2,4 ,"Sep 11, 2023"
599,core/src/main/scala/kafka/server/ForwardingManager.scala,2,2,4 ,"Sep 11, 2023"
600,core/src/main/scala/kafka/server/KafkaBroker.scala,1,1,2 ,"Sep 11, 2023"
601,core/src/main/scala/kafka/server/KafkaServer.scala,4,4,8 ,"Sep 11, 2023"
602,core/src/test/scala/unit/kafka/log/remote/RemoteIndexCacheTest.scala,26,1,27 ,"Sep 12, 2023"
603,storage/api/src/main/java/org/apache/kafka/server/log/remote/storage/RemoteStorageManager.java,1,1,2 ,"Sep 12, 2023"
604,storage/src/main/java/org/apache/kafka/storage/internals/log/RemoteIndexCache.java,6,0,6 ,"Sep 12, 2023"
605,storage/src/test/java/org/apache/kafka/server/log/remote/storage/LocalTieredStorage.java,8,3,11 ,"Sep 12, 2023"
606,storage/src/test/java/org/apache/kafka/server/log/remote/storage/LocalTieredStorageTest.java,1,7,8 ,"Sep 12, 2023"
607,storage/src/main/java/org/apache/kafka/server/log/remote/metadata/storage/TopicBasedRemoteLogMetadataManagerConfig.java,1,1,2 ,"Sep 12, 2023"
608,clients/src/main/java/org/apache/kafka/clients/consumer/internals/AssignorSelection.java,84,0,84 ,"Sep 13, 2023"
609,clients/src/main/java/org/apache/kafka/clients/consumer/internals/MemberState.java,82,0,82 ,"Sep 13, 2023"
610,clients/src/main/java/org/apache/kafka/clients/consumer/internals/MembershipManager.java,62,0,62 ,"Sep 13, 2023"
611,checkstyle/suppressions.xml,1,1,2 ,"Sep 13, 2023"
612,group-coordinator/src/main/java/org/apache/kafka/coordinator/group/GroupCoordinatorService.java,37,5,42 ,"Sep 13, 2023"
613,group-coordinator/src/main/java/org/apache/kafka/coordinator/group/GroupCoordinatorShard.java,18,0,18 ,"Sep 13, 2023"
614,group-coordinator/src/main/java/org/apache/kafka/coordinator/group/GroupMetadataManager.java,147,0,147 ,"Sep 13, 2023"
615,group-coordinator/src/main/java/org/apache/kafka/coordinator/group/generic/GenericGroup.java,2,2,4 ,"Sep 13, 2023"
616,group-coordinator/src/main/java/org/apache/kafka/coordinator/group/runtime/CoordinatorResult.java,4,4,8 ,"Sep 13, 2023"
617,group-coordinator/src/main/java/org/apache/kafka/coordinator/group/runtime/CoordinatorRuntime.java,2,2,4 ,"Sep 13, 2023"
618,core/src/main/scala/kafka/server/ReplicaManager.scala,65,46,111 ,"Sep 13, 2023"
619,core/src/test/scala/unit/kafka/server/ReplicaManagerTest.scala,65,4,69 ,"Sep 13, 2023"
620,bin/kafka-get-offsets.sh,1,1,2 ,"Sep 11, 2023"
621,bin/windows/kafka-get-offsets.bat,1,1,2 ,"Sep 11, 2023"
622,core/src/main/scala/kafka/tools/GetOffsetShell.scala,0,283,283 ,"Sep 11, 2023"
623,core/src/main/java/kafka/log/remote/RemoteLogManager.java,55,39,94 ,"Sep 12, 2023"
624,streams/src/test/java/org/apache/kafka/streams/processor/internals/StoreChangelogReaderTest.java,5,1,6 ,"Sep 6, 2023"
625,metadata/src/main/java/org/apache/kafka/metadata/migration/KRaftMigrationDriver.java,4,3,7 ,"Sep 6, 2023"
626,metadata/src/main/java/org/apache/kafka/metadata/migration/MigrationManifest.java,4,2,6 ,"Sep 6, 2023"
627,metadata/src/test/java/org/apache/kafka/metadata/migration/MigrationManifestTest.java,102,0,102 ,"Sep 6, 2023"
628,raft/src/main/java/org/apache/kafka/raft/FileBasedStateStore.java,19,12,31 ,"Sep 7, 2023"
629,raft/src/test/java/org/apache/kafka/raft/FileBasedStateStoreTest.java,16,0,16 ,"Sep 7, 2023"
630,clients/src/main/java/org/apache/kafka/clients/admin/EndpointType.java,47,0,47 ,"Sep 7, 2023"
631,clients/src/main/java/org/apache/kafka/common/errors/MismatchedEndpointTypeException.java,23,0,23 ,"Sep 7, 2023"
632,clients/src/main/java/org/apache/kafka/common/errors/UnknownControllerIdException.java,23,0,23 ,"Sep 7, 2023"
633,clients/src/main/java/org/apache/kafka/common/errors/UnsupportedEndpointTypeException.java,23,0,23 ,"Sep 7, 2023"
634,clients/src/main/java/org/apache/kafka/common/protocol/ApiKeys.java,2,1,3 ,"Sep 7, 2023"
635,clients/src/main/java/org/apache/kafka/common/protocol/Errors.java,7,1,8 ,"Sep 7, 2023"
636,clients/src/main/java/org/apache/kafka/common/requests/AbstractRequest.java,2,0,2 ,"Sep 7, 2023"
637,clients/src/main/java/org/apache/kafka/common/requests/AbstractResponse.java,2,0,2 ,"Sep 7, 2023"
638,clients/src/main/java/org/apache/kafka/common/requests/ControllerRegistrationRequest.java,73,0,73 ,"Sep 7, 2023"
639,clients/src/main/java/org/apache/kafka/common/requests/ControllerRegistrationResponse.java,61,0,61 ,"Sep 7, 2023"
640,clients/src/main/resources/common/message/ControllerRegistrationRequest.json,51,0,51 ,"Sep 7, 2023"
641,docs/connect.html,5,0,5 ,"Sep 5, 2023"
642,clients/src/main/java/org/apache/kafka/clients/consumer/KafkaConsumer.java,2,1,3 ,"Sep 8, 2023"
643,streams/src/test/java/org/apache/kafka/streams/state/internals/WindowStoreBuilderTest.java,11,37,48 ,"Sep 4, 2023"
644,clients/src/main/java/org/apache/kafka/common/protocol/ApiKeys.java,2,1,3 ,"Sep 7, 2023"
645,clients/src/main/java/org/apache/kafka/common/requests/AbstractRequest.java,2,0,2 ,"Sep 7, 2023"
646,clients/src/main/java/org/apache/kafka/common/requests/AbstractResponse.java,2,0,2 ,"Sep 7, 2023"
647,clients/src/main/java/org/apache/kafka/common/requests/ConsumerGroupDescribeRequest.java,86,0,86 ,"Sep 7, 2023"
648,clients/src/main/java/org/apache/kafka/common/requests/ConsumerGroupDescribeResponse.java,77,0,77 ,"Sep 7, 2023"
649,clients/src/main/resources/common/message/ConsumerGroupDescribeRequest.json,33,0,33 ,"Sep 7, 2023"
650,clients/src/main/resources/common/message/ConsumerGroupDescribeResponse.json,99,0,99 ,"Sep 7, 2023"
651,clients/src/test/java/org/apache/kafka/common/requests/ConsumerGroupDescribeRequestTest.java,50,0,50 ,"Sep 7, 2023"
652,storage/src/test/java/org/apache/kafka/tiered/storage/actions/ConsumeAction.java,2,3,5 ,"Sep 5, 2023"
653,docs/ops.html,4,4,8 ,"Sep 8, 2023"
654,clients/src/main/java/org/apache/kafka/clients/admin/internals/ListOffsetsHandler.java,1,1,2 ,"Sep 7, 2023"
655,clients/src/main/java/org/apache/kafka/clients/admin/internals/PartitionLeaderStrategy.java,14,0,14 ,"Sep 7, 2023"
656,clients/src/test/java/org/apache/kafka/clients/admin/KafkaAdminClientTest.java,51,10,61 ,"Sep 7, 2023"
657,docs/connect.html,2,2,4 ,"Sep 5, 2023"
658,docs/toc.html,8,0,8 ,"Sep 5, 2023"
659,docs/streams/developer-guide/config-streams.html,0,17,17 ,"Sep 7, 2023"
660,core/src/main/java/kafka/server/ReplicaFetcherTierStateMachine.java,1,1,2 ,"Sep 5, 2023"
661,core/src/main/scala/kafka/cluster/Partition.scala,5,2,7 ,"Sep 5, 2023"
662,core/src/main/scala/kafka/log/LogManager.scala,6,2,8 ,"Sep 5, 2023"
663,core/src/main/scala/kafka/log/UnifiedLog.scala,5,3,8 ,"Sep 5, 2023"
664,core/src/test/scala/unit/kafka/log/UnifiedLogTest.scala,44,4,48 ,"Sep 5, 2023"
665,storage/src/test/java/org/apache/kafka/tiered/storage/integration/BaseReassignReplicaTest.java,100,0,100 ,"Sep 5, 2023"
666,storage/src/test/java/org/apache/kafka/tiered/storage/integration/PartitionsExpandTest.java,2,1,3 ,"Sep 5, 2023"
667,storage/src/test/java/org/apache/kafka/tiered/storage/integration/ReassignReplicaExpandTest.java,32,0,32 ,"Sep 5, 2023"
668,storage/src/test/java/org/apache/kafka/tiered/storage/integration/ReassignReplicaMoveTest.java,32,0,32 ,"Sep 5, 2023"
669,streams/src/main/java/org/apache/kafka/streams/processor/internals/StreamsProducer.java,3,2,5 ,"Sep 3, 2023"
670,streams/src/test/java/org/apache/kafka/streams/processor/internals/StreamsProducerTest.java,28,0,28 ,"Sep 3, 2023"
671,metadata/src/test/java/org/apache/kafka/controller/QuorumControllerTest.java,1,1,2 ,"Sep 4, 2023"
672,core/src/test/scala/integration/kafka/server/DynamicBrokerReconfigurationTest.scala,0,1,1,"Sep 3, 2023"
673,core/src/test/scala/unit/kafka/network/SocketServerTest.scala,1,1,2 ,"Sep 3, 2023"
674,storage/src/test/java/org/apache/kafka/tiered/storage/TieredStorageTestHarness.java,0,2,2 ,"Sep 3, 2023"
675,storage/api/src/main/java/org/apache/kafka/server/log/remote/storage/RemoteStorageManager.java,3,3,6 ,"Sep 7, 2023"
676,core/src/main/scala/kafka/server/KafkaConfig.scala,1,0,1,"Sep 4, 2023"
677,docs/security.html,9,5,14 ,"Sep 4, 2023"
678,core/src/main/scala/kafka/server/DynamicBrokerConfig.scala,6,2,8 ,"Sep 5, 2023"
679,core/src/main/scala/kafka/server/KafkaConfig.scala,1,1,2 ,"Sep 5, 2023"
680,core/src/test/scala/integration/kafka/server/DynamicBrokerReconfigurationTest.scala,32,0,32 ,"Sep 5, 2023"
681,core/src/test/scala/unit/kafka/log/ProducerStateManagerTest.scala,9,2,11 ,"Sep 5, 2023"
682,core/src/test/scala/unit/kafka/log/UnifiedLogTest.scala,60,0,60 ,"Sep 5, 2023"
683,core/src/test/scala/unit/kafka/server/ReplicaManagerTest.scala,74,0,74 ,"Sep 5, 2023"
684,storage/src/main/java/org/apache/kafka/storage/internals/log/ProducerStateManagerConfig.java,9,3,12 ,"Sep 5, 2023"
685,core/src/main/java/kafka/log/remote/RemoteLogManager.java,41,27,68 ,"Sep 6, 2023"
686,core/src/main/scala/kafka/server/ReplicaManager.scala,3,11,14 ,"Sep 6, 2023"
687,core/src/test/java/kafka/log/remote/RemoteLogManagerTest.java,22,10,32 ,"Sep 6, 2023"
688,core/src/test/scala/unit/kafka/server/ReplicaManagerTest.scala,23,16,39 ,"Sep 6, 2023"
689,core/src/main/java/kafka/log/remote/RemoteLogManager.java,1,1,2 ,"Sep 4, 2023"
690,core/src/main/scala/kafka/server/BrokerServer.scala,9,5,14 ,"Sep 4, 2023"
691,core/src/main/scala/kafka/server/KafkaServer.scala,5,4,9 ,"Sep 4, 2023"
692,storage/src/test/java/org/apache/kafka/tiered/storage/TieredStorageTestContext.java,2,1,3 ,"Sep 4, 2023"
693,storage/src/test/java/org/apache/kafka/tiered/storage/TieredStorageTestHarness.java,21,7,28 ,"Sep 4, 2023"
694,storage/src/test/java/org/apache/kafka/tiered/storage/actions/ExpectEmptyRemoteStorageAction.java,6,2,8 ,"Sep 4, 2023"
695,storage/src/test/java/org/apache/kafka/tiered/storage/integration/BaseDeleteSegmentsTest.java,72,0,72 ,"Sep 4, 2023"
696,storage/src/test/java/org/apache/kafka/tiered/storage/integration/DeleteSegmentsByRetentionSizeTest.java,30,0,30 ,"Sep 4, 2023"
697,storage/src/test/java/org/apache/kafka/tiered/storage/integration/DeleteSegmentsByRetentionTimeTest.java,30,0,30 ,"Sep 4, 2023"
698,storage/src/test/java/org/apache/kafka/tiered/storage/integration/EnableRemoteLogOnTopicTest.java,89,0,89 ,"Sep 4, 2023"
699,clients/src/main/resources/common/message/OffsetFetchRequest.json,16,5,21 ,"Sep 6, 2023"
700,clients/src/main/resources/common/message/OffsetFetchResponse.json,15,2,17 ,"Sep 6, 2023"
701,clients/src/test/java/org/apache/kafka/common/requests/RequestResponseTest.java,22,22,44 ,"Sep 6, 2023"
702,core/src/test/scala/unit/kafka/server/OffsetFetchRequestTest.scala,1,0,1,"Sep 6, 2023"
703,group-coordinator/src/main/java/org/apache/kafka/coordinator/group/Group.java,9,1,10 ,"Sep 6, 2023"
704,group-coordinator/src/main/java/org/apache/kafka/coordinator/group/OffsetMetadataManager.java,11,7,18 ,"Sep 6, 2023"
705,group-coordinator/src/main/java/org/apache/kafka/coordinator/group/consumer/ConsumerGroup.java,35,6,41 ,"Sep 6, 2023"
706,group-coordinator/src/main/java/org/apache/kafka/coordinator/group/generic/GenericGroup.java,9,1,10 ,"Sep 6, 2023"
707,core/src/main/java/kafka/log/remote/RemoteLogManager.java,4,1,5 ,"Sep 4, 2023"
708,core/src/test/java/kafka/log/remote/RemoteLogManagerTest.java,54,0,54 ,"Sep 4, 2023"
709,streams/src/test/java/org/apache/kafka/streams/kstream/internals/AbstractStreamTest.java,11,12,23 ,"Sep 4, 2023"
710,streams/src/test/java/org/apache/kafka/streams/state/internals/metrics/RocksDBMetricsRecordingTriggerTest.java,17,22,39 ,"Sep 4, 2023"
711,docs/design.html,3,2,5 ,"Sep 8, 2023"
712,core/src/main/java/kafka/log/remote/RemoteLogManager.java,39,5,44 ,"Sep 7, 2023"
713,core/src/test/java/kafka/log/remote/RemoteLogManagerTest.java,111,2,113 ,"Sep 7, 2023"
714,storage/src/test/java/org/apache/kafka/tiered/storage/integration/BaseReassignReplicaTest.java,8,6,14 ,"Sep 7, 2023"
715,reviewers.py,5,6,11 ,"Sep 6, 2023"
716,core/src/main/java/kafka/log/remote/RemoteLogManager.java,67,41,108 ,"Sep 7, 2023"
717,storage/src/test/java/org/apache/kafka/tiered/storage/TieredStorageTestBuilder.java,6,2,8 ,"Sep 7, 2023"
718,checkstyle/suppressions.xml,1,1,2 ,"Sep 5, 2023"
719,clients/src/main/java/org/apache/kafka/clients/ClusterConnectionStates.java,10,6,16 ,"Sep 5, 2023"
720,clients/src/main/java/org/apache/kafka/clients/CommonClientConfigs.java,53,7,60 ,"Sep 5, 2023"
721,clients/src/main/java/org/apache/kafka/clients/GroupRebalanceConfig.java,4,0,4 ,"Sep 5, 2023"
722,docs/ops.html,57,0,57 ,"Sep 5, 2023"
723,docs/toc.html,1,0,1,"Sep 5, 2023"
724,clients/src/main/java/org/apache/kafka/clients/NetworkClientUtils.java,18,0,18 ,"Sep 7, 2023"
725,clients/src/main/java/org/apache/kafka/clients/consumer/ConsumerConfig.java,3,3,6 ,"Sep 7, 2023"
726,clients/src/main/java/org/apache/kafka/clients/consumer/internals/AbstractFetch.java,11,11,22 ,"Sep 7, 2023"
727,clients/src/main/java/org/apache/kafka/clients/consumer/internals/CommitRequestManager.java,19,7,26 ,"Sep 7, 2023"
728,clients/src/main/java/org/apache/kafka/clients/consumer/internals/CompletedFetch.java,26,6,32 ,"Sep 7, 2023"
729,clients/src/main/java/org/apache/kafka/clients/consumer/internals/ConsumerNetworkClient.java,3,4,7 ,"Sep 7, 2023"
730,clients/src/main/java/org/apache/kafka/clients/consumer/internals/CoordinatorRequestManager.java,8,4,12 ,"Sep 7, 2023"
731,connect/mirror/src/main/java/org/apache/kafka/connect/mirror/OffsetSyncStore.java,1,2,3 ,"Sep 7, 2023"
732,connect/runtime/src/main/java/org/apache/kafka/connect/util/TopicAdmin.java,21,11,32 ,"Sep 7, 2023"
733,checkstyle/import-control.xml,4,0,4 ,"Sep 7, 2023"
734,core/src/test/scala/unit/kafka/admin/ReassignPartitionsCommandArgsTest.scala,0,284,284 ,"Sep 7, 2023"
735,raft/src/main/java/org/apache/kafka/raft/FileBasedStateStore.java,5,0,5 ,"Aug 30, 2023"
736,raft/src/test/java/org/apache/kafka/raft/FileBasedStateStoreTest.java,57,0,57 ,"Aug 30, 2023"
737,core/src/main/scala/kafka/log/LogLoader.scala,7,2,9 ,"Sep 1, 2023"
738,core/src/main/scala/kafka/log/UnifiedLog.scala,15,7,22 ,"Sep 1, 2023"
739,core/src/test/scala/unit/kafka/log/LogLoaderTest.scala,48,0,48 ,"Sep 1, 2023"
740,storage/src/test/java/org/apache/kafka/tiered/storage/TieredStorageTestContext.java,30,3,33 ,"Sep 1, 2023"
741,storage/src/test/java/org/apache/kafka/tiered/storage/integration/OffloadAndConsumeFromLeaderTest.java,24,25,49 ,"Sep 1, 2023"
742,streams/src/test/java/org/apache/kafka/streams/processor/internals/GlobalProcessorContextImplTest.java,2,2,4 ,"Aug 29, 2023"
743,streams/src/test/java/org/apache/kafka/streams/processor/internals/StoreToProcessorContextAdapterTest.java,25,24,49 ,"Aug 29, 2023"
744,storage/src/main/java/org/apache/kafka/storage/internals/log/ProducerStateManager.java,1,1,2 ,"Aug 25, 2023"
745,streams/src/main/java/org/apache/kafka/streams/processor/internals/StreamThread.java,6,2,8 ,"Sep 3, 2023"
746,core/src/main/scala/kafka/log/LogManager.scala,24,5,29 ,"Aug 30, 2023"
747,core/src/test/scala/unit/kafka/log/LogManagerTest.scala,53,0,53 ,"Aug 30, 2023"
748,core/src/main/scala/kafka/controller/TopicDeletionManager.scala,1,1,2 ,"Aug 28, 2023"
749,storage/src/test/java/org/apache/kafka/server/log/remote/metadata/storage/RemoteLogSegmentLifecycleTest.java,1,1,2 ,"Aug 31, 2023"
750,storage/src/test/java/org/apache/kafka/server/log/remote/metadata/storage/TopicBasedRemoteLogMetadataManagerRestartTest.java,10,7,17 ,"Aug 28, 2023"
751,metadata/src/main/java/org/apache/kafka/image/loader/MetadataBatchLoader.java,14,1,15 ,"Aug 25, 2023"
752,metadata/src/main/java/org/apache/kafka/image/loader/MetadataLoader.java,6,2,8 ,"Aug 25, 2023"
753,metadata/src/test/java/org/apache/kafka/image/loader/MetadataLoaderTest.java,52,1,53 ,"Aug 25, 2023"
754,core/src/main/scala/kafka/log/LogManager.scala,8,3,11 ,"Aug 30, 2023"
755,core/src/main/scala/kafka/server/ConfigHandler.scala,3,1,4 ,"Aug 30, 2023"
756,core/src/test/scala/integration/kafka/admin/RemoteTopicCrudTest.scala,39,3,42 ,"Aug 30, 2023"
757,core/src/test/scala/unit/kafka/log/LogManagerTest.scala,1,1,2 ,"Aug 30, 2023"
758,storage/src/main/java/org/apache/kafka/storage/internals/log/LogConfig.java,11,6,17 ,"Aug 30, 2023"
759,connect/runtime/src/main/java/org/apache/kafka/connect/runtime/AbstractHerder.java,1,1,2 ,"Aug 24, 2023"
760,connect/runtime/src/main/java/org/apache/kafka/connect/runtime/standalone/StandaloneHerder.java,1,1,2 ,"Aug 24, 2023"
761,connect/runtime/src/test/java/org/apache/kafka/connect/runtime/distributed/DistributedHerderTest.java,7,0,7 ,"Aug 24, 2023"
762,connect/runtime/src/test/java/org/apache/kafka/connect/runtime/standalone/StandaloneHerderTest.java,9,0,9 ,"Aug 24, 2023"
763,release.py,2,2,4 ,"Aug 28, 2023"
764,clients/src/main/java/org/apache/kafka/clients/Metadata.java,5,0,5 ,"Sep 1, 2023"
765,clients/src/main/java/org/apache/kafka/clients/consumer/internals/DefaultBackgroundThread.java,31,10,41 ,"Sep 1, 2023"
766,clients/src/main/java/org/apache/kafka/clients/consumer/internals/DefaultEventHandler.java,11,0,11 ,"Sep 1, 2023"
767,streams/src/test/java/org/apache/kafka/streams/processor/internals/RecordCollectorTest.java,14,30,44 ,"Aug 28, 2023"
768,streams/src/test/java/org/apache/kafka/streams/processor/internals/StateRestoreCallbackAdapterTest.java,4,1,5 ,"Aug 28, 2023"
769,streams/src/test/java/org/apache/kafka/streams/processor/internals/StoreToProcessorContextAdapterTest.java,5,6,11 ,"Aug 28, 2023"
770,storage/src/main/java/org/apache/kafka/server/log/remote/metadata/storage/ConsumerManager.java,13,19,32 ,"Aug 26, 2023"
771,storage/src/main/java/org/apache/kafka/server/log/remote/metadata/storage/ConsumerTask.java,323,223,546 ,"Aug 26, 2023"
772,storage/src/main/java/org/apache/kafka/server/log/remote/metadata/storage/RemoteLogMetadataCache.java,11,0,11 ,"Aug 26, 2023"
773,storage/src/main/java/org/apache/kafka/server/log/remote/metadata/storage/RemotePartitionMetadataEventHandler.java,5,0,5 ,"Aug 26, 2023"
774,storage/src/main/java/org/apache/kafka/server/log/remote/metadata/storage/RemotePartitionMetadataStore.java,19,0,19 ,"Aug 26, 2023"
775,storage/src/main/java/org/apache/kafka/server/log/remote/metadata/storage/TopicBasedRemoteLogMetadataManager.java,9,11,20 ,"Aug 26, 2023"
776,tests/kafkatest/services/security/minikdc.py,7,2,9 ,"Aug 25, 2023"
777,docs/js/templateData.js,3,3,6 ,"Aug 24, 2023"
778,gradle.properties,1,1,2 ,"Aug 24, 2023"
779,kafka-merge-pr.py,1,1,2 ,"Aug 24, 2023"
780,streams/quickstart/java/pom.xml,1,1,2 ,"Aug 24, 2023"
781,streams/quickstart/java/src/main/resources/archetype-resources/pom.xml,1,1,2 ,"Aug 24, 2023"
782,streams/quickstart/pom.xml,1,1,2 ,"Aug 24, 2023"
783,tests/kafkatest/__init__.py,1,1,2 ,"Aug 24, 2023"
784,tests/kafkatest/version.py,4,0,4 ,"Aug 24, 2023"
785,clients/src/main/java/org/apache/kafka/clients/consumer/internals/PrototypeAsyncConsumer.java,42,12,54 ,"Aug 29, 2023"
786,clients/src/main/java/org/apache/kafka/clients/consumer/internals/WakeupTrigger.java,105,0,105 ,"Aug 29, 2023"
787,clients/src/test/java/org/apache/kafka/clients/consumer/internals/PrototypeAsyncConsumerTest.java,25,2,27 ,"Aug 29, 2023"
788,clients/src/test/java/org/apache/kafka/clients/consumer/internals/WakeupTriggerTest.java,78,0,78 ,"Aug 29, 2023"
789,core/src/test/scala/unit/kafka/admin/DeleteConsumerGroupsTest.scala,46,34,80 ,"Aug 29, 2023"
790,core/src/test/scala/unit/kafka/server/DescribeClusterRequestTest.scala,24,11,35 ,"Aug 29, 2023"
791,core/src/main/scala/kafka/coordinator/group/GroupCoordinatorAdapter.scala,12,11,23 ,"Sep 1, 2023"
792,core/src/main/scala/kafka/server/KafkaApis.scala,24,25,49 ,"Sep 1, 2023"
793,core/src/test/scala/unit/kafka/coordinator/group/GroupCoordinatorAdapterTest.scala,14,12,26 ,"Sep 1, 2023"
794,core/src/test/scala/unit/kafka/server/KafkaApisTest.scala,41,32,73 ,"Sep 1, 2023"
795,clients/src/test/java/org/apache/kafka/clients/producer/KafkaProducerTest.java,26,0,26 ,"Aug 25, 2023"
796,clients/src/test/java/org/apache/kafka/clients/producer/internals/BuiltInPartitionerTest.java,8,0,8 ,"Aug 25, 2023"
797,connect/runtime/src/main/java/org/apache/kafka/connect/runtime/AbstractHerder.java,3,2,5 ,"Aug 29, 2023"
798,connect/runtime/src/main/java/org/apache/kafka/connect/runtime/ConnectorConfig.java,4,1,5 ,"Aug 29, 2023"
799,connect/runtime/src/main/java/org/apache/kafka/connect/runtime/SinkConnectorConfig.java,55,19,74 ,"Aug 29, 2023"
800,connect/runtime/src/main/java/org/apache/kafka/connect/runtime/distributed/DistributedHerder.java,22,7,29 ,"Aug 29, 2023"
801,core/src/test/scala/integration/kafka/server/DynamicBrokerReconfigurationTest.scala,1,0,1,"Aug 31, 2023"
802,storage/src/test/java/org/apache/kafka/tiered/storage/TieredStorageTestHarness.java,2,0,2 ,"Aug 31, 2023"
803,storage/src/test/java/org/apache/kafka/server/log/remote/metadata/storage/TopicBasedRemoteLogMetadataManagerWrapperWithHarness.java,1,1,2 ,"Sep 1, 2023"
804,clients/src/main/java/org/apache/kafka/common/requests/AlterPartitionRequest.java,10,6,16 ,"Aug 28, 2023"
805,clients/src/test/java/org/apache/kafka/common/requests/AlterPartitionRequestTest.java,13,0,13 ,"Aug 28, 2023"
806,checkstyle/suppressions.xml,2,2,4 ,"Aug 24, 2023"
807,core/src/main/java/kafka/log/remote/RemoteLogManager.java,444,11,455 ,"Aug 24, 2023"
808,core/src/main/scala/kafka/log/LogManager.scala,2,1,3 ,"Aug 24, 2023"
809,core/src/main/scala/kafka/log/UnifiedLog.scala,117,36,153 ,"Aug 24, 2023"
810,core/src/main/scala/kafka/server/BrokerServer.scala,7,1,8 ,"Aug 24, 2023"
811,core/src/main/scala/kafka/server/KafkaServer.scala,7,1,8 ,"Aug 24, 2023"
812,streams/src/main/java/org/apache/kafka/streams/processor/internals/StreamsPartitionAssignor.java,32,20,52 ,"Aug 30, 2023"
813,streams/src/main/java/org/apache/kafka/streams/processor/internals/assignment/ClientState.java,5,1,6 ,"Aug 30, 2023"
814,streams/src/test/java/org/apache/kafka/streams/processor/internals/StreamsPartitionAssignorTest.java,60,0,60 ,"Aug 30, 2023"
815,connect/runtime/src/main/java/org/apache/kafka/connect/runtime/rest/RestServer.java,13,1,14 ,"Aug 29, 2023"
816,build.gradle,16,1,17 ,"Aug 28, 2023"
817,docs/configuration.html,5,0,5 ,"Aug 28, 2023"
818,docs/toc.html,1,0,1,"Aug 28, 2023"
819,storage/src/main/java/org/apache/kafka/server/log/remote/metadata/storage/TopicBasedRemoteLogMetadataManagerConfig.java,15,11,26 ,"Aug 28, 2023"
820,storage/src/main/java/org/apache/kafka/server/log/remote/storage/RemoteLogManagerConfig.java,29,25,54 ,"Aug 28, 2023"
821,group-coordinator/src/main/java/org/apache/kafka/coordinator/group/Group.java,5,0,5 ,"Aug 28, 2023"
822,group-coordinator/src/main/java/org/apache/kafka/coordinator/group/GroupCoordinatorService.java,60,6,66 ,"Aug 28, 2023"
823,group-coordinator/src/main/java/org/apache/kafka/coordinator/group/GroupCoordinatorShard.java,37,0,37 ,"Aug 28, 2023"
824,group-coordinator/src/main/java/org/apache/kafka/coordinator/group/GroupMetadataManager.java,13,1,14 ,"Aug 28, 2023"
825,checkstyle/import-control-storage.xml,1,0,1,"Aug 28, 2023"
826,core/src/main/java/kafka/log/remote/RemoteLogManager.java,2,2,4 ,"Aug 28, 2023"
827,core/src/test/scala/integration/kafka/admin/RemoteTopicCrudTest.scala,8,11,19 ,"Aug 28, 2023"
828,storage/src/test/java/org/apache/kafka/server/log/remote/storage/LocalTieredStorage.java,2,15,17 ,"Aug 28, 2023"
829,storage/src/test/java/org/apache/kafka/server/log/remote/storage/LocalTieredStorageCondition.java,12,4,16 ,"Aug 28, 2023"
830,storage/src/test/java/org/apache/kafka/server/log/remote/storage/LocalTieredStorageEvent.java,6,0,6 ,"Aug 28, 2023"
831,storage/src/test/java/org/apache/kafka/tiered/storage/TieredStorageTestContext.java,4,5,9 ,"Aug 28, 2023"
832,storage/src/test/java/org/apache/kafka/tiered/storage/TieredStorageTestHarness.java,4,2,6 ,"Aug 28, 2023"
833,storage/src/test/java/org/apache/kafka/tiered/storage/actions/ProduceAction.java,1,0,1,"Aug 28, 2023"
834,storage/src/test/java/org/apache/kafka/tiered/storage/integration/OffloadAndConsumeFromLeaderTest.java,3,3,6 ,"Aug 28, 2023"
835,storage/src/test/java/org/apache/kafka/tiered/storage/utils/RecordsKeyValueMatcher.java,7,2,9 ,"Aug 28, 2023"
836,streams/src/main/java/org/apache/kafka/streams/processor/internals/TaskExecutionMetadata.java,1,1,2 ,"Aug 31, 2023"
837,streams/src/main/java/org/apache/kafka/streams/processor/internals/tasks/DefaultTaskExecutor.java,47,4,51 ,"Aug 31, 2023"
838,streams/src/test/java/org/apache/kafka/streams/processor/internals/tasks/DefaultTaskExecutorTest.java,26,0,26 ,"Aug 31, 2023"
839,Jenkinsfile,1,1,2 ,"Aug 12, 2023"
840,connect/mirror-client/src/main/java/org/apache/kafka/connect/mirror/DefaultReplicationPolicy.java,17,3,20 ,"Aug 15, 2023"
841,connect/mirror-client/src/main/java/org/apache/kafka/connect/mirror/MirrorClientConfig.java,14,0,14 ,"Aug 15, 2023"
842,connect/mirror-client/src/test/java/org/apache/kafka/connect/mirror/ReplicationPolicyTest.java,53,0,53 ,"Aug 15, 2023"
843,connect/mirror/src/main/java/org/apache/kafka/connect/mirror/MirrorConnectorConfig.java,11,0,11 ,"Aug 15, 2023"
844,bin/connect-plugin-path.sh,21,0,21 ,"Aug 11, 2023"
845,bin/windows/connect-plugin-path.bat,21,0,21 ,"Aug 11, 2023"
846,build.gradle,5,0,5 ,"Aug 11, 2023"
847,checkstyle/import-control.xml,2,0,2 ,"Aug 11, 2023"
848,config/tools-log4j.properties,3,0,3 ,"Aug 11, 2023"
849,connect/runtime/src/main/java/org/apache/kafka/connect/runtime/isolation/PluginScanner.java,5,5,10 ,"Aug 11, 2023"
850,connect/runtime/src/main/java/org/apache/kafka/connect/runtime/isolation/PluginSource.java,5,3,8 ,"Aug 11, 2023"
851,connect/runtime/src/main/java/org/apache/kafka/connect/runtime/isolation/PluginUtils.java,33,17,50 ,"Aug 11, 2023"
852,connect/runtime/src/main/java/org/apache/kafka/connect/runtime/isolation/Plugins.java,1,1,2 ,"Aug 11, 2023"
853,connect/runtime/src/main/java/org/apache/kafka/connect/runtime/isolation/ReflectionScanner.java,4,4,8 ,"Aug 11, 2023"
854,connect/runtime/src/test/java/org/apache/kafka/connect/runtime/isolation/TestPlugins.java,30,2,32 ,"Aug 11, 2023"
855,connect/runtime/src/test/resources/test-plugins/non-migrated/META-INF/services/org.apache.kafka.connect.connector.policy.ConnectorClientConfigOverridePolicy,16,0,16 ,"Aug 11, 2023"
856,connect/runtime/src/test/resources/test-plugins/non-migrated/test/plugins/NonMigratedConverter.java,46,0,46 ,"Aug 11, 2023"
857,docs/streams/architecture.html,7,0,7 ,"Aug 11, 2023"
858,docs/streams/developer-guide/config-streams.html,60,0,60 ,"Aug 11, 2023"
859,docs/streams/upgrade-guide.html,7,0,7 ,"Aug 11, 2023"
860,docs/upgrade.html,6,0,6 ,"Aug 11, 2023"
861,streams/src/main/java/org/apache/kafka/streams/StreamsConfig.java,2,2,4 ,"Aug 11, 2023"
862,streams/src/test/java/org/apache/kafka/streams/StreamsConfigTest.java,2,2,4 ,"Aug 11, 2023"
863,core/src/main/scala/kafka/log/LogManager.scala,1,1,2 ,"Aug 15, 2023"
864,core/src/main/scala/kafka/server/ControllerConfigurationValidator.scala,2,2,4 ,"Aug 15, 2023"
865,core/src/main/scala/kafka/server/ControllerServer.scala,1,1,2 ,"Aug 15, 2023"
866,core/src/main/scala/kafka/server/ZkAdminManager.scala,1,1,2 ,"Aug 15, 2023"
867,core/src/main/scala/kafka/zk/AdminZkClient.scala,10,5,15 ,"Aug 15, 2023"
868,clients/src/main/java/org/apache/kafka/clients/ClientUtils.java,121,0,121 ,"Aug 14, 2023"
869,clients/src/main/java/org/apache/kafka/clients/admin/KafkaAdminClient.java,8,28,36 ,"Aug 14, 2023"
870,connect/runtime/src/test/java/org/apache/kafka/connect/runtime/isolation/SynchronizationTest.java,16,8,24 ,"Aug 15, 2023"
871,core/src/main/scala/kafka/controller/KafkaController.scala,1,1,2 ,"Aug 15, 2023"
872,core/src/test/scala/unit/kafka/metrics/MetricsTest.scala,12,1,13 ,"Aug 15, 2023"
873,streams/src/main/java/org/apache/kafka/streams/processor/internals/PunctuationQueue.java,19,1,20 ,"Aug 14, 2023"
874,streams/src/main/java/org/apache/kafka/streams/processor/internals/StreamTask.java,12,2,14 ,"Aug 14, 2023"
875,streams/src/main/java/org/apache/kafka/streams/processor/internals/tasks/DefaultTaskExecutor.java,27,6,33 ,"Aug 14, 2023"
876,streams/src/main/java/org/apache/kafka/streams/processor/internals/tasks/DefaultTaskManager.java,17,5,22 ,"Aug 14, 2023"
877,streams/src/main/java/org/apache/kafka/streams/processor/internals/tasks/TaskExecutorCreator.java,3,1,4 ,"Aug 14, 2023"
878,streams/src/test/java/org/apache/kafka/streams/processor/internals/PunctuationQueueTest.java,50,19,69 ,"Aug 14, 2023"
879,clients/src/main/java/org/apache/kafka/clients/consumer/internals/CommitRequestManager.java,5,0,5 ,"Aug 15, 2023"
880,clients/src/test/java/org/apache/kafka/clients/consumer/internals/CommitRequestManagerTest.java,33,2,35 ,"Aug 15, 2023"
881,core/src/test/scala/unit/kafka/server/AbstractFetcherThreadTest.scala,39,547,586 ,"Aug 11, 2023"
882,core/src/test/scala/unit/kafka/server/FetcherThreadTestUtils.scala,37,0,37 ,"Aug 11, 2023"
883,core/src/test/scala/unit/kafka/server/MockFetcherThread.scala,170,0,170 ,"Aug 11, 2023"
884,core/src/main/java/kafka/log/remote/RemoteLogManager.java,7,5,12 ,"Aug 11, 2023"
885,core/src/test/java/kafka/log/remote/RemoteLogManagerTest.java,71,2,73 ,"Aug 11, 2023"
886,storage/src/main/java/org/apache/kafka/server/log/remote/storage/RemoteLogManagerConfig.java,7,4,11 ,"Aug 11, 2023"
887,streams/src/test/java/org/apache/kafka/streams/kstream/internals/graph/TableSourceNodeTest.java,11,16,27 ,"Aug 12, 2023"
888,core/src/main/scala/kafka/server/ControllerServer.scala,25,26,51 ,"Aug 15, 2023"
889,server-common/src/main/java/org/apache/kafka/server/util/json/DecodeJson.java,2,2,4 ,"Aug 11, 2023"
890,tools/src/main/java/org/apache/kafka/tools/reassign/ActiveMoveState.java,60,0,60 ,"Aug 11, 2023"
891,tools/src/main/java/org/apache/kafka/tools/reassign/CancelledMoveState.java,57,0,57 ,"Aug 11, 2023"
892,tools/src/main/java/org/apache/kafka/tools/reassign/CompletedMoveState.java,52,0,52 ,"Aug 11, 2023"
893,tools/src/main/java/org/apache/kafka/tools/reassign/LogDirMoveState.java,28,0,28 ,"Aug 11, 2023"
894,tools/src/main/java/org/apache/kafka/tools/reassign/MissingLogDirMoveState.java,52,0,52 ,"Aug 11, 2023"
895,tools/src/main/java/org/apache/kafka/tools/reassign/MissingReplicaMoveState.java,52,0,52 ,"Aug 11, 2023"
896,tools/src/main/java/org/apache/kafka/tools/reassign/PartitionMove.java,52,0,52 ,"Aug 11, 2023"
897,docs/connect.html,68,1,69 ,"Aug 10, 2023"
898,docs/toc.html,1,0,1,"Aug 10, 2023"
899,core/src/main/scala/kafka/cluster/Partition.scala,14,8,22 ,"Aug 14, 2023"
900,core/src/test/scala/unit/kafka/cluster/PartitionTest.scala,42,0,42 ,"Aug 14, 2023"
901,streams/src/test/java/org/apache/kafka/streams/processor/internals/assignment/HighAvailabilityTaskAssignorTest.java,2,2,4 ,"Aug 12, 2023"
902,streams/src/test/java/org/apache/kafka/streams/processor/internals/assignment/StickyTaskAssignorTest.java,2,2,4 ,"Aug 12, 2023"
903,clients/src/main/java/org/apache/kafka/clients/consumer/internals/PrototypeAsyncConsumer.java,1,1,2 ,"Aug 11, 2023"
904,clients/src/main/java/org/apache/kafka/clients/consumer/internals/events/ApplicationEventProcessor.java,12,2,14 ,"Aug 11, 2023"
905,clients/src/main/java/org/apache/kafka/clients/consumer/internals/events/OffsetFetchApplicationEvent.java,16,8,24 ,"Aug 11, 2023"
906,clients/src/test/java/org/apache/kafka/clients/consumer/internals/PrototypeAsyncConsumerTest.java,28,9,37 ,"Aug 11, 2023"
907,core/src/test/scala/integration/kafka/api/BaseAsyncConsumerTest.scala,16,4,20 ,"Aug 11, 2023"
908,streams/src/test/java/org/apache/kafka/streams/kstream/internals/SessionCacheFlushListenerTest.java,10,12,22 ,"Aug 16, 2023"
909,streams/src/test/java/org/apache/kafka/streams/kstream/internals/TimestampedCacheFlushListenerTest.java,13,19,32 ,"Aug 16, 2023"
910,streams/src/test/java/org/apache/kafka/streams/kstream/internals/TimestampedTupleForwarderTest.java,19,22,41 ,"Aug 16, 2023"
911,streams/src/test/java/org/apache/kafka/streams/state/internals/SessionStoreBuilderTest.java,15,39,54 ,"Aug 16, 2023"
912,build.gradle,1,0,1,"Aug 10, 2023"
913,connect/runtime/src/main/java/org/apache/kafka/connect/tools/SchemaSourceTask.java,1,1,2 ,"Aug 10, 2023"
914,connect/runtime/src/main/java/org/apache/kafka/connect/tools/VerifiableSourceTask.java,1,1,2 ,"Aug 10, 2023"
915,connect/runtime/src/test/java/org/apache/kafka/connect/integration/MonitorableSourceConnector.java,1,1,2 ,"Aug 10, 2023"
916,checkstyle/import-control.xml,3,0,3 ,"Aug 10, 2023"
917,build.gradle,15,1,16 ,"Aug 16, 2023"
918,connect/runtime/src/main/java/org/apache/kafka/connect/runtime/rest/resources/ConnectorPluginsResource.java,7,27,34 ,"Aug 16, 2023"
919,connect/runtime/src/test/java/org/apache/kafka/connect/runtime/rest/resources/ConnectorPluginsResourceTest.java,0,10,10 ,"Aug 16, 2023"
920,clients/src/main/java/org/apache/kafka/clients/NodeApiVersions.java,1,1,2 ,"Aug 11, 2023"
921,clients/src/test/java/org/apache/kafka/common/protocol/ApiKeysTest.java,1,1,2 ,"Aug 11, 2023"
922,clients/src/test/java/org/apache/kafka/common/requests/ApiVersionsResponseTest.java,5,4,9 ,"Aug 11, 2023"
923,clients/src/main/java/org/apache/kafka/common/protocol/ApiKeys.java,4,0,4 ,"Aug 14, 2023"
924,core/src/test/scala/unit/kafka/server/RequestQuotaTest.scala,111,43,154 ,"Aug 14, 2023"
925,streams/src/test/java/org/apache/kafka/streams/processor/internals/ActiveTaskCreatorTest.java,18,26,44 ,"Aug 16, 2023"
926,streams/src/test/java/org/apache/kafka/streams/processor/internals/ChangelogTopicsTest.java,13,22,35 ,"Aug 16, 2023"
927,storage/src/main/java/org/apache/kafka/server/log/remote/storage/RemoteLogManagerConfig.java,3,3,6 ,"Aug 16, 2023"
928,storage/src/test/java/org/apache/kafka/server/log/remote/storage/RemoteLogManagerConfigTest.java,14,4,18 ,"Aug 16, 2023"
929,examples/src/main/java/kafka/examples/Consumer.java,5,0,5 ,"Aug 11, 2023"
930,streams/src/main/java/org/apache/kafka/streams/kstream/KStream.java,16,32,48 ,"Aug 11, 2023"
931,clients/src/main/java/org/apache/kafka/common/config/provider/ConfigProvider.java,4,3,7 ,"Aug 15, 2023"
932,connect/api/src/main/java/org/apache/kafka/connect/connector/policy/ConnectorClientConfigOverridePolicy.java,3,0,3 ,"Aug 15, 2023"
933,connect/api/src/main/java/org/apache/kafka/connect/rest/ConnectRestExtension.java,4,3,7 ,"Aug 15, 2023"
934,connect/api/src/main/java/org/apache/kafka/connect/sink/SinkConnector.java,3,0,3 ,"Aug 15, 2023"
935,connect/api/src/main/java/org/apache/kafka/connect/source/SourceConnector.java,3,0,3 ,"Aug 15, 2023"
936,connect/api/src/main/java/org/apache/kafka/connect/storage/Converter.java,3,0,3 ,"Aug 15, 2023"
937,connect/api/src/main/java/org/apache/kafka/connect/storage/HeaderConverter.java,3,0,3 ,"Aug 15, 2023"
938,connect/api/src/main/java/org/apache/kafka/connect/transforms/Transformation.java,3,0,3 ,"Aug 15, 2023"
939,connect/api/src/main/java/org/apache/kafka/connect/transforms/predicates/Predicate.java,3,1,4 ,"Aug 15, 2023"
940,streams/src/test/java/org/apache/kafka/streams/state/internals/metrics/RocksDBMetricsRecorderGaugesTest.java,6,13,19 ,"Aug 15, 2023"
941,core/src/test/java/kafka/test/ClusterTestExtensionsTest.java,1,1,2 ,"Aug 14, 2023"
942,core/src/test/java/kafka/test/annotation/ClusterTest.java,1,1,2 ,"Aug 14, 2023"
943,build.gradle,1,1,2 ,"Aug 11, 2023"
944,connect/runtime/src/main/java/org/apache/kafka/connect/util/KafkaBasedLog.java,2,2,4 ,"Aug 11, 2023"
945,Jenkinsfile,1,1,2 ,"Aug 12, 2023"
946,connect/mirror-client/src/main/java/org/apache/kafka/connect/mirror/DefaultReplicationPolicy.java,17,3,20 ,"Aug 15, 2023"
947,connect/mirror-client/src/main/java/org/apache/kafka/connect/mirror/MirrorClientConfig.java,14,0,14 ,"Aug 15, 2023"
948,connect/mirror-client/src/test/java/org/apache/kafka/connect/mirror/ReplicationPolicyTest.java,53,0,53 ,"Aug 15, 2023"
949,connect/mirror/src/main/java/org/apache/kafka/connect/mirror/MirrorConnectorConfig.java,11,0,11 ,"Aug 15, 2023"
950,bin/connect-plugin-path.sh,21,0,21 ,"Aug 11, 2023"
951,bin/windows/connect-plugin-path.bat,21,0,21 ,"Aug 11, 2023"
952,build.gradle,5,0,5 ,"Aug 11, 2023"
953,checkstyle/import-control.xml,2,0,2 ,"Aug 11, 2023"
954,config/tools-log4j.properties,3,0,3 ,"Aug 11, 2023"
955,connect/runtime/src/main/java/org/apache/kafka/connect/runtime/isolation/PluginScanner.java,5,5,10 ,"Aug 11, 2023"
956,connect/runtime/src/main/java/org/apache/kafka/connect/runtime/isolation/PluginSource.java,5,3,8 ,"Aug 11, 2023"
957,connect/runtime/src/main/java/org/apache/kafka/connect/runtime/isolation/PluginUtils.java,33,17,50 ,"Aug 11, 2023"
958,connect/runtime/src/main/java/org/apache/kafka/connect/runtime/isolation/Plugins.java,1,1,2 ,"Aug 11, 2023"
959,connect/runtime/src/main/java/org/apache/kafka/connect/runtime/isolation/ReflectionScanner.java,4,4,8 ,"Aug 11, 2023"
960,connect/runtime/src/test/java/org/apache/kafka/connect/runtime/isolation/TestPlugins.java,30,2,32 ,"Aug 11, 2023"
961,connect/runtime/src/test/resources/test-plugins/non-migrated/META-INF/services/org.apache.kafka.connect.connector.policy.ConnectorClientConfigOverridePolicy,16,0,16 ,"Aug 11, 2023"
962,connect/runtime/src/test/resources/test-plugins/non-migrated/test/plugins/NonMigratedConverter.java,46,0,46 ,"Aug 11, 2023"
963,docs/streams/architecture.html,7,0,7 ,"Aug 11, 2023"
964,docs/streams/developer-guide/config-streams.html,60,0,60 ,"Aug 11, 2023"
965,docs/streams/upgrade-guide.html,7,0,7 ,"Aug 11, 2023"
966,docs/upgrade.html,6,0,6 ,"Aug 11, 2023"
967,streams/src/main/java/org/apache/kafka/streams/StreamsConfig.java,2,2,4 ,"Aug 11, 2023"
968,streams/src/test/java/org/apache/kafka/streams/StreamsConfigTest.java,2,2,4 ,"Aug 11, 2023"
969,core/src/main/scala/kafka/log/LogManager.scala,1,1,2 ,"Aug 15, 2023"
970,core/src/main/scala/kafka/server/ControllerConfigurationValidator.scala,2,2,4 ,"Aug 15, 2023"
971,core/src/main/scala/kafka/server/ControllerServer.scala,1,1,2 ,"Aug 15, 2023"
972,core/src/main/scala/kafka/server/ZkAdminManager.scala,1,1,2 ,"Aug 15, 2023"
973,core/src/main/scala/kafka/zk/AdminZkClient.scala,10,5,15 ,"Aug 15, 2023"
974,clients/src/main/java/org/apache/kafka/clients/ClientUtils.java,121,0,121 ,"Aug 14, 2023"
975,clients/src/main/java/org/apache/kafka/clients/admin/KafkaAdminClient.java,8,28,36 ,"Aug 14, 2023"
976,connect/runtime/src/test/java/org/apache/kafka/connect/runtime/isolation/SynchronizationTest.java,16,8,24 ,"Aug 15, 2023"
977,core/src/main/scala/kafka/controller/KafkaController.scala,1,1,2 ,"Aug 15, 2023"
978,core/src/test/scala/unit/kafka/metrics/MetricsTest.scala,12,1,13 ,"Aug 15, 2023"
979,streams/src/main/java/org/apache/kafka/streams/processor/internals/PunctuationQueue.java,19,1,20 ,"Aug 14, 2023"
980,streams/src/main/java/org/apache/kafka/streams/processor/internals/StreamTask.java,12,2,14 ,"Aug 14, 2023"
981,streams/src/main/java/org/apache/kafka/streams/processor/internals/tasks/DefaultTaskExecutor.java,27,6,33 ,"Aug 14, 2023"
982,streams/src/main/java/org/apache/kafka/streams/processor/internals/tasks/DefaultTaskManager.java,17,5,22 ,"Aug 14, 2023"
983,streams/src/main/java/org/apache/kafka/streams/processor/internals/tasks/TaskExecutorCreator.java,3,1,4 ,"Aug 14, 2023"
984,streams/src/test/java/org/apache/kafka/streams/processor/internals/PunctuationQueueTest.java,50,19,69 ,"Aug 14, 2023"
985,clients/src/main/java/org/apache/kafka/clients/consumer/internals/CommitRequestManager.java,5,0,5 ,"Aug 15, 2023"
986,clients/src/test/java/org/apache/kafka/clients/consumer/internals/CommitRequestManagerTest.java,33,2,35 ,"Aug 15, 2023"
987,core/src/test/scala/unit/kafka/server/AbstractFetcherThreadTest.scala,39,547,586 ,"Aug 11, 2023"
988,core/src/test/scala/unit/kafka/server/FetcherThreadTestUtils.scala,37,0,37 ,"Aug 11, 2023"
989,core/src/test/scala/unit/kafka/server/MockFetcherThread.scala,170,0,170 ,"Aug 11, 2023"
990,core/src/main/java/kafka/log/remote/RemoteLogManager.java,7,5,12 ,"Aug 11, 2023"
991,core/src/test/java/kafka/log/remote/RemoteLogManagerTest.java,71,2,73 ,"Aug 11, 2023"
992,storage/src/main/java/org/apache/kafka/server/log/remote/storage/RemoteLogManagerConfig.java,7,4,11 ,"Aug 11, 2023"
993,streams/src/test/java/org/apache/kafka/streams/kstream/internals/graph/TableSourceNodeTest.java,11,16,27 ,"Aug 12, 2023"
994,core/src/main/scala/kafka/server/ControllerServer.scala,25,26,51 ,"Aug 15, 2023"
995,server-common/src/main/java/org/apache/kafka/server/util/json/DecodeJson.java,2,2,4 ,"Aug 11, 2023"
996,tools/src/main/java/org/apache/kafka/tools/reassign/ActiveMoveState.java,60,0,60 ,"Aug 11, 2023"
997,tools/src/main/java/org/apache/kafka/tools/reassign/CancelledMoveState.java,57,0,57 ,"Aug 11, 2023"
998,tools/src/main/java/org/apache/kafka/tools/reassign/CompletedMoveState.java,52,0,52 ,"Aug 11, 2023"
999,tools/src/main/java/org/apache/kafka/tools/reassign/LogDirMoveState.java,28,0,28 ,"Aug 11, 2023"
1000,tools/src/main/java/org/apache/kafka/tools/reassign/MissingLogDirMoveState.java,52,0,52 ,"Aug 11, 2023"
1001,tools/src/main/java/org/apache/kafka/tools/reassign/MissingReplicaMoveState.java,52,0,52 ,"Aug 11, 2023"
1002,tools/src/main/java/org/apache/kafka/tools/reassign/PartitionMove.java,52,0,52 ,"Aug 11, 2023"
1003,docs/connect.html,68,1,69 ,"Aug 10, 2023"
1004,docs/toc.html,1,0,1,"Aug 10, 2023"
1005,core/src/main/scala/kafka/cluster/Partition.scala,14,8,22 ,"Aug 14, 2023"
1006,core/src/test/scala/unit/kafka/cluster/PartitionTest.scala,42,0,42 ,"Aug 14, 2023"
1007,streams/src/test/java/org/apache/kafka/streams/processor/internals/assignment/HighAvailabilityTaskAssignorTest.java,2,2,4 ,"Aug 12, 2023"
1008,streams/src/test/java/org/apache/kafka/streams/processor/internals/assignment/StickyTaskAssignorTest.java,2,2,4 ,"Aug 12, 2023"
1009,clients/src/main/java/org/apache/kafka/clients/consumer/internals/PrototypeAsyncConsumer.java,1,1,2 ,"Aug 11, 2023"
1010,clients/src/main/java/org/apache/kafka/clients/consumer/internals/events/ApplicationEventProcessor.java,12,2,14 ,"Aug 11, 2023"
1011,clients/src/main/java/org/apache/kafka/clients/consumer/internals/events/OffsetFetchApplicationEvent.java,16,8,24 ,"Aug 11, 2023"
1012,clients/src/test/java/org/apache/kafka/clients/consumer/internals/PrototypeAsyncConsumerTest.java,28,9,37 ,"Aug 11, 2023"
1013,core/src/test/scala/integration/kafka/api/BaseAsyncConsumerTest.scala,16,4,20 ,"Aug 11, 2023"
1014,streams/src/test/java/org/apache/kafka/streams/kstream/internals/SessionCacheFlushListenerTest.java,10,12,22 ,"Aug 16, 2023"
1015,streams/src/test/java/org/apache/kafka/streams/kstream/internals/TimestampedCacheFlushListenerTest.java,13,19,32 ,"Aug 16, 2023"
1016,streams/src/test/java/org/apache/kafka/streams/kstream/internals/TimestampedTupleForwarderTest.java,19,22,41 ,"Aug 16, 2023"
1017,streams/src/test/java/org/apache/kafka/streams/state/internals/SessionStoreBuilderTest.java,15,39,54 ,"Aug 16, 2023"
1018,build.gradle,1,0,1,"Aug 10, 2023"
1019,connect/runtime/src/main/java/org/apache/kafka/connect/tools/SchemaSourceTask.java,1,1,2 ,"Aug 10, 2023"
1020,connect/runtime/src/main/java/org/apache/kafka/connect/tools/VerifiableSourceTask.java,1,1,2 ,"Aug 10, 2023"
1021,connect/runtime/src/test/java/org/apache/kafka/connect/integration/MonitorableSourceConnector.java,1,1,2 ,"Aug 10, 2023"
1022,checkstyle/import-control.xml,3,0,3 ,"Aug 10, 2023"
1023,build.gradle,15,1,16 ,"Aug 16, 2023"
1024,connect/runtime/src/main/java/org/apache/kafka/connect/runtime/rest/resources/ConnectorPluginsResource.java,7,27,34 ,"Aug 16, 2023"
1025,connect/runtime/src/test/java/org/apache/kafka/connect/runtime/rest/resources/ConnectorPluginsResourceTest.java,0,10,10 ,"Aug 16, 2023"
1026,clients/src/main/java/org/apache/kafka/clients/NodeApiVersions.java,1,1,2 ,"Aug 11, 2023"
1027,clients/src/test/java/org/apache/kafka/common/protocol/ApiKeysTest.java,1,1,2 ,"Aug 11, 2023"
1028,clients/src/test/java/org/apache/kafka/common/requests/ApiVersionsResponseTest.java,5,4,9 ,"Aug 11, 2023"
1029,clients/src/main/java/org/apache/kafka/common/protocol/ApiKeys.java,4,0,4 ,"Aug 14, 2023"
1030,core/src/test/scala/unit/kafka/server/RequestQuotaTest.scala,111,43,154 ,"Aug 14, 2023"
1031,streams/src/test/java/org/apache/kafka/streams/processor/internals/ActiveTaskCreatorTest.java,18,26,44 ,"Aug 16, 2023"
1032,streams/src/test/java/org/apache/kafka/streams/processor/internals/ChangelogTopicsTest.java,13,22,35 ,"Aug 16, 2023"
1033,storage/src/main/java/org/apache/kafka/server/log/remote/storage/RemoteLogManagerConfig.java,3,3,6 ,"Aug 16, 2023"
1034,storage/src/test/java/org/apache/kafka/server/log/remote/storage/RemoteLogManagerConfigTest.java,14,4,18 ,"Aug 16, 2023"
1035,examples/src/main/java/kafka/examples/Consumer.java,5,0,5 ,"Aug 11, 2023"
1036,streams/src/main/java/org/apache/kafka/streams/kstream/KStream.java,16,32,48 ,"Aug 11, 2023"
1037,clients/src/main/java/org/apache/kafka/common/config/provider/ConfigProvider.java,4,3,7 ,"Aug 15, 2023"
1038,connect/api/src/main/java/org/apache/kafka/connect/connector/policy/ConnectorClientConfigOverridePolicy.java,3,0,3 ,"Aug 15, 2023"
1039,connect/api/src/main/java/org/apache/kafka/connect/rest/ConnectRestExtension.java,4,3,7 ,"Aug 15, 2023"
1040,connect/api/src/main/java/org/apache/kafka/connect/sink/SinkConnector.java,3,0,3 ,"Aug 15, 2023"
1041,connect/api/src/main/java/org/apache/kafka/connect/source/SourceConnector.java,3,0,3 ,"Aug 15, 2023"
1042,connect/api/src/main/java/org/apache/kafka/connect/storage/Converter.java,3,0,3 ,"Aug 15, 2023"
1043,connect/api/src/main/java/org/apache/kafka/connect/storage/HeaderConverter.java,3,0,3 ,"Aug 15, 2023"
1044,connect/api/src/main/java/org/apache/kafka/connect/transforms/Transformation.java,3,0,3 ,"Aug 15, 2023"
1045,connect/api/src/main/java/org/apache/kafka/connect/transforms/predicates/Predicate.java,3,1,4 ,"Aug 15, 2023"
1046,release.py,1,0,1,"Aug 16, 2023"
1047,streams/src/test/java/org/apache/kafka/streams/state/internals/metrics/RocksDBMetricsRecorderGaugesTest.java,6,13,19 ,"Aug 15, 2023"
1048,core/src/test/java/kafka/test/ClusterTestExtensionsTest.java,1,1,2 ,"Aug 14, 2023"
1049,core/src/test/java/kafka/test/annotation/ClusterTest.java,1,1,2 ,"Aug 14, 2023"
1050,build.gradle,1,1,2 ,"Aug 11, 2023"
1051,connect/runtime/src/main/java/org/apache/kafka/connect/util/KafkaBasedLog.java,2,2,4 ,"Aug 11, 2023"
1052,build.gradle,2,0,2 ,"Aug 5, 2023"
1053,checkstyle/import-control.xml,4,0,4 ,"Aug 5, 2023"
1054,core/src/main/java/kafka/log/remote/RemoteLogManager.java,4,6,10 ,"Aug 5, 2023"
1055,core/src/main/java/kafka/server/builders/KafkaApisBuilder.java,2,1,3 ,"Aug 5, 2023"
1056,core/src/main/java/kafka/server/builders/ReplicaManagerBuilder.java,2,1,3 ,"Aug 5, 2023"
1057,core/src/main/scala/kafka/server/BrokerServer.scala,1,2,3 ,"Aug 5, 2023"
1058,core/src/main/scala/kafka/server/KafkaRequestHandler.scala,30,31,61 ,"Aug 5, 2023"
1059,core/src/main/scala/kafka/server/KafkaServer.scala,1,1,2 ,"Aug 5, 2023"
1060,core/src/test/java/kafka/log/remote/RemoteLogManagerTest.java,10,11,21 ,"Aug 5, 2023"
1061,core/src/test/java/kafka/log/remote/RemoteLogReaderTest.java,8,1,9 ,"Aug 5, 2023"
1062,streams/src/main/java/org/apache/kafka/streams/StreamsConfig.java,3,0,3 ,"Aug 9, 2023"
1063,streams/src/main/java/org/apache/kafka/streams/processor/internals/StreamsPartitionAssignor.java,1,1,2 ,"Aug 9, 2023"
1064,streams/src/main/java/org/apache/kafka/streams/processor/internals/assignment/FallbackPriorTaskAssignor.java,1,2,3 ,"Aug 9, 2023"
1065,streams/src/main/java/org/apache/kafka/streams/processor/internals/assignment/HighAvailabilityTaskAssignor.java,11,12,23 ,"Aug 9, 2023"
1066,streams/src/main/java/org/apache/kafka/streams/processor/internals/assignment/StandbyTaskAssignor.java,1,2,3 ,"Aug 9, 2023"
1067,streams/src/main/java/org/apache/kafka/streams/processor/internals/assignment/StickyTaskAssignor.java,1,2,3 ,"Aug 9, 2023"
1068,streams/src/main/java/org/apache/kafka/streams/processor/internals/assignment/TaskAssignor.java,1,2,3 ,"Aug 9, 2023"
1069,streams/src/test/java/org/apache/kafka/streams/integration/HighAvailabilityTaskAssignorIntegrationTest.java,46,14,60 ,"Aug 9, 2023"
1070,streams/src/test/java/org/apache/kafka/streams/integration/StreamsUncaughtExceptionHandlerIntegrationTest.java,1,1,2 ,"Aug 9, 2023"
1071,streams/src/test/java/org/apache/kafka/streams/integration/TaskMetadataIntegrationTest.java,1,1,2 ,"Aug 9, 2023"
1072,connect/runtime/src/main/java/org/apache/kafka/connect/runtime/AbstractHerder.java,16,25,41 ,"Aug 1, 2023"
1073,connect/runtime/src/main/java/org/apache/kafka/connect/runtime/isolation/PluginClassLoader.java,1,13,14 ,"Aug 1, 2023"
1074,connect/runtime/src/main/java/org/apache/kafka/connect/runtime/isolation/PluginDesc.java,17,9,26 ,"Aug 1, 2023"
1075,connect/runtime/src/main/java/org/apache/kafka/connect/runtime/isolation/PluginScanResult.java,1,1,2 ,"Aug 1, 2023"
1076,connect/runtime/src/main/java/org/apache/kafka/connect/runtime/isolation/PluginScanner.java,12,13,25 ,"Aug 1, 2023"
1077,connect/runtime/src/main/java/org/apache/kafka/connect/runtime/isolation/PluginType.java,5,11,16 ,"Aug 1, 2023"
1078,connect/runtime/src/main/java/org/apache/kafka/connect/runtime/isolation/PluginUtils.java,6,5,11 ,"Aug 1, 2023"
1079,connect/runtime/src/main/java/org/apache/kafka/connect/runtime/isolation/Plugins.java,1,1,2 ,"Aug 1, 2023"
1080,connect/runtime/src/main/java/org/apache/kafka/connect/runtime/isolation/ReflectionScanner.java,17,16,33 ,"Aug 1, 2023"
1081,core/src/main/java/kafka/server/ReplicaFetcherTierStateMachine.java,1,1,2 ,"Aug 3, 2023"
1082,core/src/main/scala/kafka/log/UnifiedLog.scala,1,1,2 ,"Aug 3, 2023"
1083,core/src/main/scala/kafka/server/DynamicBrokerConfig.scala,34,0,34 ,"Aug 3, 2023"
1084,core/src/main/scala/kafka/server/KafkaConfig.scala,12,1,13 ,"Aug 3, 2023"
1085,core/src/test/scala/unit/kafka/log/LogConfigTest.scala,30,9,39 ,"Aug 3, 2023"
1086,core/src/test/scala/unit/kafka/server/DynamicBrokerConfigTest.scala,94,0,94 ,"Aug 3, 2023"
1087,core/src/test/scala/unit/kafka/server/KafkaConfigTest.scala,25,3,28 ,"Aug 3, 2023"
1088,streams/src/main/java/org/apache/kafka/streams/processor/internals/StreamsPartitionAssignor.java,10,2,12 ,"Aug 10, 2023"
1089,streams/src/main/java/org/apache/kafka/streams/processor/internals/assignment/ClientState.java,12,0,12 ,"Aug 10, 2023"
1090,streams/src/main/java/org/apache/kafka/streams/processor/internals/assignment/FallbackPriorTaskAssignor.java,2,1,3 ,"Aug 10, 2023"
1091,streams/src/main/java/org/apache/kafka/streams/processor/internals/assignment/HighAvailabilityTaskAssignor.java,2,2,4 ,"Aug 10, 2023"
1092,streams/src/main/java/org/apache/kafka/streams/processor/internals/assignment/RackAwareTaskAssignor.java,16,4,20 ,"Aug 10, 2023"
1093,streams/src/main/java/org/apache/kafka/streams/processor/internals/assignment/StickyTaskAssignor.java,53,3,56 ,"Aug 10, 2023"
1094,streams/src/test/java/org/apache/kafka/streams/integration/utils/EmbeddedKafkaCluster.java,4,0,4 ,"Aug 10, 2023"
1095,connect/api/src/main/java/org/apache/kafka/connect/storage/SimpleHeaderConverter.java,8,1,9 ,"Aug 10, 2023"
1096,connect/api/src/main/java/org/apache/kafka/connect/storage/StringConverter.java,8,1,9 ,"Aug 10, 2023"
1097,connect/api/src/test/java/org/apache/kafka/connect/storage/SimpleHeaderConverterTest.java,6,0,6 ,"Aug 10, 2023"
1098,connect/api/src/test/java/org/apache/kafka/connect/storage/StringConverterTest.java,6,0,6 ,"Aug 10, 2023"
1099,connect/json/src/main/java/org/apache/kafka/connect/json/JsonConverter.java,8,1,9 ,"Aug 10, 2023"
1100,connect/json/src/test/java/org/apache/kafka/connect/json/JsonConverterTest.java,6,0,6 ,"Aug 10, 2023"
1101,connect/runtime/src/main/java/org/apache/kafka/connect/connector/policy/AbstractConnectorClientConfigOverridePolicy.java,8,1,9 ,"Aug 10, 2023"
1102,connect/runtime/src/main/java/org/apache/kafka/connect/converters/ByteArrayConverter.java,7,2,9 ,"Aug 10, 2023"
1103,connect/runtime/src/main/java/org/apache/kafka/connect/converters/NumberConverter.java,7,1,8 ,"Aug 10, 2023"
1104,connect/runtime/src/test/java/org/apache/kafka/connect/converters/ByteArrayConverterTest.java,6,0,6 ,"Aug 10, 2023"
1105,connect/runtime/src/test/java/org/apache/kafka/connect/converters/NumberConverterTest.java,6,0,6 ,"Aug 10, 2023"
1106,connect/runtime/src/test/java/org/apache/kafka/connect/integration/ErrorHandlingIntegrationTest.java,7,1,8 ,"Aug 10, 2023"
1107,connect/runtime/src/test/java/org/apache/kafka/connect/runtime/ConnectorConfigTest.java,36,6,42 ,"Aug 10, 2023"
1108,streams/src/main/java/org/apache/kafka/streams/processor/internals/assignment/ClientState.java,19,0,19 ,"Aug 3, 2023"
1109,streams/src/main/java/org/apache/kafka/streams/processor/internals/assignment/ClientTagAwareStandbyTaskAssignor.java,45,0,45 ,"Aug 3, 2023"
1110,connect/api/src/main/resources/META-INF/services/org.apache.kafka.connect.storage.Converter,16,0,16 ,"Aug 8, 2023"
1111,connect/api/src/main/resources/META-INF/services/org.apache.kafka.connect.storage.HeaderConverter,17,0,17 ,"Aug 8, 2023"
1112,connect/api/src/test/resources/META-INF/services/org.apache.kafka.connect.sink.SinkConnector,16,0,16 ,"Aug 8, 2023"
1113,connect/api/src/test/resources/META-INF/services/org.apache.kafka.connect.source.SourceConnector,16,0,16 ,"Aug 8, 2023"
1114,connect/file/src/main/resources/META-INF/services/org.apache.kafka.connect.sink.SinkConnector,16,0,16 ,"Aug 8, 2023"
1115,connect/file/src/main/resources/META-INF/services/org.apache.kafka.connect.source.SourceConnector,16,0,16 ,"Aug 8, 2023"
1116,connect/json/src/main/resources/META-INF/services/org.apache.kafka.connect.storage.Converter,16,0,16 ,"Aug 8, 2023"
1117,connect/json/src/main/resources/META-INF/services/org.apache.kafka.connect.storage.HeaderConverter,16,0,16 ,"Aug 8, 2023"
1118,connect/mirror/src/main/resources/META-INF/services/org.apache.kafka.connect.source.SourceConnector,18,0,18 ,"Aug 8, 2023"
1119,connect/runtime/src/main/java/org/apache/kafka/connect/runtime/WorkerConfig.java,35,0,35 ,"Aug 8, 2023"
1120,connect/runtime/src/main/java/org/apache/kafka/connect/runtime/isolation/PluginDiscoveryMode.java,65,0,65 ,"Aug 8, 2023"
1121,clients/src/main/java/org/apache/kafka/clients/consumer/internals/AbstractStickyAssignor.java,3,2,5 ,"Aug 3, 2023"
1122,clients/src/test/java/org/apache/kafka/clients/consumer/internals/AbstractStickyAssignorTest.java,86,0,86 ,"Aug 3, 2023"
1123,tests/kafkatest/services/security/minikdc.py,2,0,2 ,"Aug 7, 2023"
1124,raft/src/main/java/org/apache/kafka/raft/ElectionState.java,5,1,6 ,"Aug 9, 2023"
1125,raft/src/main/java/org/apache/kafka/raft/KafkaRaftClient.java,39,10,49 ,"Aug 9, 2023"
1126,raft/src/main/java/org/apache/kafka/raft/LeaderState.java,2,3,5 ,"Aug 9, 2023"
1127,raft/src/main/java/org/apache/kafka/raft/QuorumState.java,1,2,3 ,"Aug 9, 2023"
1128,raft/src/test/java/org/apache/kafka/raft/KafkaRaftClientSnapshotTest.java,32,0,32 ,"Aug 9, 2023"
1129,raft/src/test/java/org/apache/kafka/raft/KafkaRaftClientTest.java,30,0,30 ,"Aug 9, 2023"
1130,raft/src/test/java/org/apache/kafka/raft/MockLog.java,40,14,54 ,"Aug 9, 2023"
1131,raft/src/test/java/org/apache/kafka/raft/RaftClientTestContext.java,2,6,8 ,"Aug 9, 2023"
1132,raft/src/test/java/org/apache/kafka/raft/RaftEventSimulationTest.java,1,1,2 ,"Aug 9, 2023"
1133,connect/mirror/src/main/java/org/apache/kafka/connect/mirror/OffsetSyncStore.java,40,21,61 ,"Aug 10, 2023"
1134,connect/mirror/src/test/java/org/apache/kafka/connect/mirror/OffsetSyncStoreTest.java,76,19,95 ,"Aug 10, 2023"
1135,clients/src/main/java/org/apache/kafka/clients/NodeApiVersions.java,1,1,2 ,"Aug 10, 2023"
1136,clients/src/test/java/org/apache/kafka/clients/NodeApiVersionsTest.java,1,1,2 ,"Aug 10, 2023"
1137,core/src/test/scala/integration/kafka/admin/BrokerApiVersionsCommandTest.scala,55,31,86 ,"Aug 10, 2023"
1138,checkstyle/import-control-server-common.xml,3,0,3 ,"Aug 9, 2023"
1139,core/src/main/scala/kafka/admin/AdminUtils.scala,0,239,239 ,"Aug 9, 2023"
1140,core/src/main/scala/kafka/admin/BrokerMetadata.scala,0,23,23 ,"Aug 9, 2023"
1141,core/src/main/scala/kafka/admin/ReassignPartitionsCommand.scala,6,5,11 ,"Aug 9, 2023"
1142,core/src/main/scala/kafka/server/KafkaApis.scala,2,2,4 ,"Aug 9, 2023"
1143,core/src/main/scala/kafka/server/MetadataCache.scala,1,1,2 ,"Aug 9, 2023"
1144,core/src/main/scala/kafka/server/ZkAdminManager.scala,3,3,6 ,"Aug 9, 2023"
1145,core/src/main/scala/kafka/server/metadata/KRaftMetadataCache.scala,2,2,4 ,"Aug 9, 2023"
1146,storage/src/main/java/org/apache/kafka/storage/internals/log/TimeIndex.java,2,2,4 ,"Aug 3, 2023"
1147,storage/src/main/java/org/apache/kafka/storage/internals/log/TimestampOffset.java,7,0,7 ,"Aug 3, 2023"
1148,build.gradle,0,1,1,"Aug 10, 2023"
1149,connect/runtime/src/main/java/org/apache/kafka/connect/runtime/distributed/DistributedHerder.java,4,2,6 ,"Aug 10, 2023"
1150,streams/src/main/java/org/apache/kafka/streams/StreamsConfig.java,40,0,40 ,"Aug 7, 2023"
1151,streams/src/main/java/org/apache/kafka/streams/processor/internals/assignment/AssignorConfiguration.java,21,0,21 ,"Aug 7, 2023"
1152,streams/src/main/java/org/apache/kafka/streams/processor/internals/assignment/RackAwareTaskAssignor.java,75,50,125 ,"Aug 7, 2023"
1153,streams/src/main/java/org/apache/kafka/streams/processor/internals/ChangelogTopics.java,4,0,4 ,"Aug 8, 2023"
1154,streams/src/main/java/org/apache/kafka/streams/processor/internals/StreamsPartitionAssignor.java,11,1,12 ,"Aug 8, 2023"
1155,streams/src/main/java/org/apache/kafka/streams/processor/internals/assignment/FallbackPriorTaskAssignor.java,3,1,4 ,"Aug 8, 2023"
1156,streams/src/main/java/org/apache/kafka/streams/processor/internals/assignment/HighAvailabilityTaskAssignor.java,38,4,42 ,"Aug 8, 2023"
1157,streams/src/main/java/org/apache/kafka/streams/processor/internals/assignment/RackAwareTaskAssignor.java,3,0,3 ,"Aug 8, 2023"
1158,streams/src/main/java/org/apache/kafka/streams/processor/internals/assignment/StandbyTaskAssignor.java,16,0,16 ,"Aug 8, 2023"
1159,streams/src/main/java/org/apache/kafka/streams/processor/internals/assignment/StickyTaskAssignor.java,2,0,2 ,"Aug 8, 2023"
1160,streams/src/main/java/org/apache/kafka/streams/processor/internals/assignment/TaskAssignor.java,7,4,11 ,"Aug 8, 2023"
1161,streams/src/test/java/org/apache/kafka/streams/processor/internals/assignment/FallbackPriorTaskAssignorTest.java,1,0,1,"Aug 8, 2023"
1162,core/src/main/scala/kafka/server/BrokerServer.scala,7,11,18 ,"Aug 10, 2023"
1163,core/src/main/scala/kafka/server/ControllerServer.scala,15,4,19 ,"Aug 10, 2023"
1164,core/src/main/scala/kafka/server/metadata/AclPublisher.scala,102,0,102 ,"Aug 10, 2023"
1165,core/src/main/scala/kafka/server/metadata/BrokerMetadataPublisher.scala,3,40,43 ,"Aug 10, 2023"
1166,core/src/test/scala/unit/kafka/security/authorizer/AuthorizerTest.scala,2,1,3 ,"Aug 10, 2023"
1167,core/src/test/scala/unit/kafka/server/metadata/BrokerMetadataPublisherTest.scala,1,1,2 ,"Aug 10, 2023"
1168,metadata/src/main/java/org/apache/kafka/controller/AclControlManager.java,6,43,49 ,"Aug 10, 2023"
1169,streams/src/main/java/org/apache/kafka/streams/query/RangeQuery.java,2,1,3 ,"Aug 8, 2023"
1170,streams/src/test/java/org/apache/kafka/streams/integration/IQv2StoreIntegrationTest.java,2,9,11 ,"Aug 8, 2023"
1171,checkstyle/suppressions.xml,1,0,1,"Aug 4, 2023"
1172,core/src/main/java/kafka/log/remote/CustomMetadataSizeLimitExceededException.java,20,0,20 ,"Aug 4, 2023"
1173,core/src/main/java/kafka/log/remote/RemoteLogManager.java,34,5,39 ,"Aug 4, 2023"
1174,core/src/test/java/kafka/log/remote/RemoteLogManagerTest.java,103,8,111 ,"Aug 4, 2023"
1175,streams/src/main/java/org/apache/kafka/streams/processor/internals/StreamsPartitionAssignor.java,4,4,8 ,"Aug 2, 2023"
1176,streams/src/main/java/org/apache/kafka/streams/processor/internals/assignment/ClientState.java,15,5,20 ,"Aug 2, 2023"
1177,streams/src/main/java/org/apache/kafka/streams/processor/internals/assignment/ClientTagAwareStandbyTaskAssignor.java,40,23,63 ,"Aug 2, 2023"
1178,streams/src/main/java/org/apache/kafka/streams/processor/internals/assignment/HighAvailabilityTaskAssignor.java,1,1,2 ,"Aug 2, 2023"
1179,server-common/src/main/java/org/apache/kafka/timeline/SnapshottableHashTable.java,4,2,6 ,"Aug 8, 2023"
1180,server-common/src/test/java/org/apache/kafka/timeline/SnapshottableHashTableTest.java,15,0,15 ,"Aug 8, 2023"
1181,connect/runtime/src/main/java/org/apache/kafka/connect/util/RetryUtil.java,1,1,2 ,"Aug 3, 2023"
1182,connect/runtime/src/test/java/org/apache/kafka/connect/util/RetryUtilTest.java,6,6,12 ,"Aug 3, 2023"
1183,connect/runtime/src/test/java/org/apache/kafka/connect/runtime/InternalSinkRecordTest.java,3,0,3 ,"Aug 9, 2023"
1184,connect/runtime/src/test/java/org/apache/kafka/connect/runtime/TransformationStageTest.java,3,0,3 ,"Aug 9, 2023"
1185,connect/runtime/src/test/java/org/apache/kafka/connect/runtime/WorkerConfigTransformerTest.java,1,1,2 ,"Aug 9, 2023"
1186,connect/runtime/src/test/java/org/apache/kafka/connect/runtime/distributed/DistributedConfigTest.java,4,4,8 ,"Aug 9, 2023"
1187,connect/runtime/src/test/java/org/apache/kafka/connect/runtime/distributed/IncrementalCooperativeAssignorTest.java,3,0,3 ,"Aug 9, 2023"
1188,connect/runtime/src/test/java/org/apache/kafka/connect/runtime/distributed/WorkerCoordinatorIncrementalTest.java,2,1,3 ,"Aug 9, 2023"
1189,connect/runtime/src/test/java/org/apache/kafka/connect/runtime/distributed/WorkerCoordinatorTest.java,7,0,7 ,"Aug 9, 2023"
1190,connect/runtime/src/test/java/org/apache/kafka/connect/runtime/distributed/WorkerGroupMemberTest.java,3,0,3 ,"Aug 9, 2023"
1191,connect/runtime/src/test/java/org/apache/kafka/connect/runtime/health/ConnectClusterStateImplTest.java,1,1,2 ,"Aug 9, 2023"
1192,connect/runtime/src/test/java/org/apache/kafka/connect/runtime/isolation/DelegatingClassLoaderTest.java,3,0,3 ,"Aug 9, 2023"
1193,connect/runtime/src/test/java/org/apache/kafka/connect/runtime/rest/ConnectRestServerTest.java,3,0,3 ,"Aug 9, 2023"
1194,connect/runtime/src/test/java/org/apache/kafka/connect/runtime/rest/InternalRequestSignatureTest.java,3,0,3 ,"Aug 9, 2023"
1195,connect/runtime/src/test/java/org/apache/kafka/connect/runtime/rest/RestClientTest.java,3,2,5 ,"Aug 9, 2023"
1196,connect/runtime/src/test/java/org/apache/kafka/connect/runtime/rest/resources/ConnectorPluginsResourceTest.java,3,0,3 ,"Aug 9, 2023"
1197,connect/runtime/src/test/java/org/apache/kafka/connect/runtime/rest/resources/LoggingResourceTest.java,3,8,11 ,"Aug 9, 2023"
1198,connect/runtime/src/test/java/org/apache/kafka/connect/storage/FileOffsetBackingStoreTest.java,3,0,3 ,"Aug 9, 2023"
1199,connect/runtime/src/test/java/org/apache/kafka/connect/storage/KafkaStatusBackingStoreFormatTest.java,3,0,3 ,"Aug 9, 2023"
1200,connect/runtime/src/test/java/org/apache/kafka/connect/storage/KafkaStatusBackingStoreTest.java,3,1,4 ,"Aug 9, 2023"
1201,connect/runtime/src/test/java/org/apache/kafka/connect/storage/OffsetStorageWriterTest.java,3,0,3 ,"Aug 9, 2023"
1202,streams/src/main/java/org/apache/kafka/streams/processor/internals/TaskManager.java,1,1,2 ,"Aug 4, 2023"
1203,streams/src/main/java/org/apache/kafka/streams/processor/internals/Tasks.java,5,0,5 ,"Aug 4, 2023"
1204,streams/src/main/java/org/apache/kafka/streams/processor/internals/TasksRegistry.java,2,0,2 ,"Aug 4, 2023"
1205,streams/src/test/java/org/apache/kafka/streams/processor/internals/TaskManagerTest.java,31,1,32 ,"Aug 4, 2023"
1206,streams/src/test/java/org/apache/kafka/streams/processor/internals/TasksTest.java,25,0,25 ,"Aug 4, 2023"
1207,core/src/main/scala/kafka/server/metadata/KRaftMetadataCache.scala,1,1,2 ,"Aug 10, 2023"
1208,core/src/test/scala/unit/kafka/server/MetadataCacheTest.scala,38,2,40 ,"Aug 10, 2023"
1209,clients/src/test/java/org/apache/kafka/clients/admin/KafkaAdminClientTest.java,69,0,69 ,"Aug 10, 2023"
1210,streams/src/main/java/org/apache/kafka/streams/processor/api/ProcessingContext.java,3,1,4 ,"Aug 8, 2023"
1211,streams/src/test/java/org/apache/kafka/streams/processor/internals/assignment/AssignmentTestUtils.java,4,2,6 ,"Aug 8, 2023"
1212,streams/src/main/java/org/apache/kafka/streams/kstream/internals/foreignkeyjoin/ResponseJoinProcessorSupplier.java,5,0,5 ,"Aug 5, 2023"
1213,core/src/main/java/kafka/log/remote/RemoteLogManager.java,68,33,101 ,"Aug 2, 2023"
1214,core/src/test/java/kafka/log/remote/RemoteLogManagerTest.java,78,3,81 ,"Aug 2, 2023"
1215,raft/src/main/java/org/apache/kafka/snapshot/FileRawSnapshotWriter.java,3,0,3 ,"Aug 8, 2023"
1216,LICENSE-binary,2,2,4 ,"Aug 1, 2023"
1217,build.gradle,4,0,4 ,"Aug 1, 2023"
1218,docs/upgrade.html,12,0,12 ,"Aug 1, 2023"
1219,gradle/dependencies.gradle,1,1,2 ,"Aug 1, 2023"
1220,docs/streams/developer-guide/config-streams.html,1,1,2 ,"Aug 6, 2023"
1221,tools/src/main/java/org/apache/kafka/tools/ConsumerPerformance.java,0,1,1,"Jul 21, 2023"
1222,tools/src/main/java/org/apache/kafka/tools/MetadataQuorumCommand.java,0,1,1,"Jul 21, 2023"
1223,tools/src/main/java/org/apache/kafka/tools/ProducerPerformance.java,0,1,1,"Jul 21, 2023"
1224,gradle/dependencies.gradle,1,1,2 ,"Jul 21, 2023"
1225,metadata/src/main/java/org/apache/kafka/image/writer/ImageWriterOptions.java,16,3,19 ,"Jul 24, 2023"
1226,metadata/src/test/java/org/apache/kafka/image/ImageDowngradeTest.java,1,1,2 ,"Jul 24, 2023"
1227,metadata/src/test/java/org/apache/kafka/image/writer/ImageWriterOptionsTest.java,21,0,21 ,"Jul 24, 2023"
1228,streams/src/main/java/org/apache/kafka/streams/kstream/internals/KStreamImpl.java,3,2,5 ,"Jul 20, 2023"
1229,streams/src/main/java/org/apache/kafka/streams/kstream/internals/graph/StreamTableJoinNode.java,16,1,17 ,"Jul 20, 2023"
1230,streams/src/main/java/org/apache/kafka/streams/processor/internals/InternalTopologyBuilder.java,9,0,9 ,"Jul 20, 2023"
1231,streams/src/test/java/org/apache/kafka/streams/kstream/internals/KStreamKTableJoinTest.java,70,0,70 ,"Jul 20, 2023"
1232,checkstyle/suppressions.xml,7,5,12 ,"Jul 19, 2023"
1233,clients/src/main/java/org/apache/kafka/common/requests/JoinGroupRequest.java,62,0,62 ,"Jul 19, 2023"
1234,core/src/main/scala/kafka/server/BrokerServer.scala,6,1,7 ,"Jul 19, 2023"
1235,group-coordinator/src/main/java/org/apache/kafka/coordinator/group/GroupCoordinatorConfig.java,41,1,42 ,"Jul 19, 2023"
1236,group-coordinator/src/main/java/org/apache/kafka/coordinator/group/GroupCoordinatorService.java,35,5,40 ,"Jul 19, 2023"
1237,clients/src/main/java/org/apache/kafka/clients/consumer/internals/CommitRequestManager.java,1,1,2 ,"Jul 21, 2023"
1238,clients/src/main/java/org/apache/kafka/clients/consumer/internals/ConsumerCoordinator.java,1,1,2 ,"Jul 21, 2023"
1239,clients/src/main/java/org/apache/kafka/common/errors/StaleMemberEpochException.java,32,0,32 ,"Jul 21, 2023"
1240,clients/src/main/java/org/apache/kafka/common/protocol/Errors.java,3,1,4 ,"Jul 21, 2023"
1241,clients/src/main/java/org/apache/kafka/common/requests/AbstractRequest.java,8,1,9 ,"Jul 21, 2023"
1242,clients/src/main/java/org/apache/kafka/common/requests/ConsumerGroupHeartbeatRequest.java,5,1,6 ,"Jul 21, 2023"
1243,clients/src/main/java/org/apache/kafka/common/requests/OffsetCommitRequest.java,24,25,49 ,"Jul 21, 2023"
1244,clients/src/main/resources/common/message/OffsetCommitRequest.json,9,3,12 ,"Jul 21, 2023"
1245,clients/src/main/resources/common/message/OffsetCommitResponse.json,14,1,15 ,"Jul 21, 2023"
1246,clients/src/test/java/org/apache/kafka/clients/consumer/internals/ConsumerCoordinatorTest.java,1,1,2 ,"Jul 21, 2023"
1247,clients/src/test/java/org/apache/kafka/common/message/MessageTest.java,2,2,4 ,"Jul 21, 2023"
1248,clients/src/test/java/org/apache/kafka/common/requests/OffsetCommitRequestTest.java,22,20,42 ,"Jul 21, 2023"
1249,clients/src/test/java/org/apache/kafka/common/requests/RequestResponseTest.java,1,1,2 ,"Jul 21, 2023"
1250,core/src/main/scala/kafka/coordinator/group/GroupCoordinatorAdapter.scala,1,1,2 ,"Jul 21, 2023"
1251,core/src/main/scala/kafka/server/KafkaApis.scala,1,1,2 ,"Jul 21, 2023"
1252,core/src/test/scala/integration/kafka/api/AuthorizerIntegrationTest.scala,2,1,3 ,"Jul 21, 2023"
1253,core/src/test/scala/unit/kafka/coordinator/group/GroupCoordinatorAdapterTest.scala,2,2,4 ,"Jul 21, 2023"
1254,gradle/dependencies.gradle,1,1,2 ,"Jul 19, 2023"
1255,gradle/wrapper/gradle-wrapper.properties,2,2,4 ,"Jul 19, 2023"
1256,gradlew,1,1,2 ,"Jul 19, 2023"
1257,docs/toc.html,2,1,3 ,"Jul 20, 2023"
1258,docs/ops.html,17,1,18 ,"Jul 18, 2023"
1259,connect/api/src/main/java/org/apache/kafka/connect/source/SourceTask.java,4,3,7 ,"Jul 18, 2023"
1260,clients/src/main/java/org/apache/kafka/clients/consumer/internals/CommitRequestManager.java,3,4,7 ,"Jul 21, 2023"
1261,clients/src/main/java/org/apache/kafka/clients/consumer/internals/DefaultBackgroundThread.java,18,6,24 ,"Jul 21, 2023"
1262,clients/src/main/java/org/apache/kafka/clients/consumer/internals/DefaultEventHandler.java,3,0,3 ,"Jul 21, 2023"
1263,clients/src/main/java/org/apache/kafka/clients/consumer/internals/PrototypeAsyncConsumer.java,31,2,33 ,"Jul 21, 2023"
1264,clients/src/main/java/org/apache/kafka/clients/consumer/internals/events/ApplicationEvent.java,1,1,2 ,"Jul 21, 2023"
1265,clients/src/main/java/org/apache/kafka/clients/consumer/internals/events/ApplicationEventProcessor.java,27,3,30 ,"Jul 21, 2023"
1266,clients/src/main/java/org/apache/kafka/clients/consumer/internals/events/AssignmentChangeApplicationEvent.java,33,0,33 ,"Jul 21, 2023"
1267,clients/src/main/java/org/apache/kafka/clients/consumer/internals/events/NewTopicsMetadataUpdateRequestEvent.java,24,0,24 ,"Jul 21, 2023"
1268,clients/src/test/java/org/apache/kafka/clients/consumer/internals/CommitRequestManagerTest.java,1,1,2 ,"Jul 21, 2023"
1269,streams/src/main/java/org/apache/kafka/streams/processor/internals/assignment/Graph.java,377,0,377 ,"Jul 20, 2023"
1270,checkstyle/suppressions.xml,1,1,2 ,"Jul 21, 2023"
1271,core/src/test/java/kafka/log/remote/RemoteLogManagerTest.java,80,0,80 ,"Jul 21, 2023"
1272,connect/runtime/src/main/java/org/apache/kafka/connect/runtime/isolation/PluginScanner.java,59,11,70 ,"Jul 19, 2023"
1273,connect/runtime/src/main/java/org/apache/kafka/connect/runtime/isolation/PluginSource.java,3,1,4 ,"Jul 19, 2023"
1274,connect/runtime/src/main/java/org/apache/kafka/connect/runtime/isolation/PluginUtils.java,1,1,2 ,"Jul 19, 2023"
1275,connect/runtime/src/main/java/org/apache/kafka/connect/runtime/isolation/ReflectionScanner.java,29,25,54 ,"Jul 19, 2023"
1276,connect/runtime/src/main/java/org/apache/kafka/connect/runtime/isolation/ServiceLoaderScanner.java,80,0,80 ,"Jul 19, 2023"
1277,release.py,16,8,24 ,"Jul 19, 2023"
1278,storage/src/main/java/org/apache/kafka/server/log/remote/metadata/storage/RemoteLogLeaderEpochState.java,18,6,24 ,"Jul 24, 2023"
1279,storage/src/test/java/org/apache/kafka/server/log/remote/metadata/storage/RemoteLogLeaderEpochStateTest.java,206,0,206 ,"Jul 24, 2023"
1280,core/src/main/scala/kafka/server/DelayedProduce.scala,7,2,9 ,"Jul 19, 2023"
1281,core/src/main/scala/kafka/server/FetchSession.scala,21,0,21 ,"Jul 19, 2023"
1282,connect/api/src/main/java/org/apache/kafka/connect/sink/SinkTaskContext.java,1,1,2 ,"Jul 19, 2023"
1283,connect/api/src/main/java/org/apache/kafka/connect/source/SourceTaskContext.java,1,1,2 ,"Jul 19, 2023"
1284,build.gradle,8,1,9 ,"Jul 18, 2023"
1285,connect/mirror/src/main/java/org/apache/kafka/connect/mirror/MirrorCheckpointConfig.java,91,87,178 ,"Jul 18, 2023"
1286,connect/mirror/src/main/java/org/apache/kafka/connect/mirror/MirrorConnectorConfig.java,4,0,4 ,"Jul 18, 2023"
1287,connect/mirror/src/main/java/org/apache/kafka/connect/mirror/MirrorHeartbeatConfig.java,9,5,14 ,"Jul 18, 2023"
1288,checkstyle/import-control.xml,1,0,1,"Jul 21, 2023"
1289,connect/api/src/main/java/org/apache/kafka/connect/sink/SinkRecord.java,136,8,144 ,"Jul 21, 2023"
1290,connect/api/src/main/java/org/apache/kafka/connect/sink/SinkTask.java,28,9,37 ,"Jul 21, 2023"
1291,connect/api/src/test/java/org/apache/kafka/connect/sink/SinkRecordTest.java,34,2,36 ,"Jul 21, 2023"
1292,checkstyle/import-control.xml,0,4,4 ,"Jul 20, 2023"
1293,streams/src/test/java/org/apache/kafka/streams/integration/AbstractResetIntegrationTest.java,1,1,2 ,"Jul 20, 2023"
1294,streams/src/test/java/org/apache/kafka/streams/integration/ResetIntegrationTest.java,5,5,10 ,"Jul 20, 2023"
1295,README.md,1,1,2 ,"Jul 21, 2023"
1296,storage/src/main/java/org/apache/kafka/server/log/remote/metadata/storage/ConsumerManager.java,23,10,33 ,"Jul 22, 2023"
1297,storage/src/main/java/org/apache/kafka/server/log/remote/metadata/storage/ConsumerTask.java,12,3,15 ,"Jul 22, 2023"
1298,storage/src/main/java/org/apache/kafka/server/log/remote/metadata/storage/TopicBasedRemoteLogMetadataManager.java,11,25,36 ,"Jul 22, 2023"
1299,storage/src/main/java/org/apache/kafka/server/log/remote/metadata/storage/TopicBasedRemoteLogMetadataManagerConfig.java,8,0,8 ,"Jul 22, 2023"
1300,storage/src/test/java/org/apache/kafka/server/log/remote/metadata/storage/RemoteLogSegmentLifecycleTest.java,5,3,8 ,"Jul 22, 2023"
1301,licenses/classgraph-MIT,0,21,21 ,"Jul 20, 2023"
1302,LICENSE-binary,2,1,3 ,"Jul 19, 2023"
1303,connect/runtime/src/main/java/org/apache/kafka/connect/runtime/isolation/ReflectionScanner.java,4,27,31 ,"Jul 19, 2023"
1304,gradle/dependencies.gradle,1,1,2 ,"Jul 19, 2023"
1305,storage/src/main/java/org/apache/kafka/storage/internals/log/LogFileUtils.java,1,1,2 ,"Jul 22, 2023"
1306,storage/src/test/java/org/apache/kafka/server/log/remote/storage/LocalTieredStorage.java,17,17,34 ,"Jul 22, 2023"
1307,storage/src/test/java/org/apache/kafka/server/log/remote/storage/LocalTieredStorageTest.java,41,36,77 ,"Jul 22, 2023"
1308,storage/src/test/java/org/apache/kafka/server/log/remote/storage/RemoteLogSegmentFileset.java,18,16,34 ,"Jul 22, 2023"
1309,checkstyle/import-control.xml,1,0,1,"Jul 21, 2023"
1310,group-coordinator/src/main/java/org/apache/kafka/coordinator/group/OffsetAndMetadata.java,125,0,125 ,"Jul 21, 2023"
1311,group-coordinator/src/main/java/org/apache/kafka/coordinator/group/RecordHelpers.java,69,0,69 ,"Jul 21, 2023"
1312,group-coordinator/src/test/java/org/apache/kafka/coordinator/group/OffsetAndMetadataTest.java,74,0,74 ,"Jul 21, 2023"
1313,streams/src/test/java/org/apache/kafka/streams/processor/internals/TaskManagerTest.java,41,56,97 ,"Jul 20, 2023"
1314,connect/runtime/src/main/java/org/apache/kafka/connect/runtime/isolation/PluginUtils.java,4,2,6 ,"Jul 19, 2023"
1315,connect/runtime/src/test/java/org/apache/kafka/connect/runtime/isolation/PluginsTest.java,6,1,7 ,"Jul 19, 2023"
1316,connect/runtime/src/test/resources/test-plugins/read-version-from-resource-v1/test/plugins/ReadVersionFromResource.java,11,1,12 ,"Jul 19, 2023"
1317,connect/runtime/src/test/resources/test-plugins/read-version-from-resource-v2/test/plugins/ReadVersionFromResource.java,11,1,12 ,"Jul 19, 2023"
1318,build.gradle,0,2,2 ,"Jul 20, 2023"
1319,checkstyle/import-control.xml,0,2,2 ,"Jul 20, 2023"
1320,connect/api/src/main/java/org/apache/kafka/connect/sink/SinkRecord.java,1,1,2 ,"Jul 20, 2023"
1321,connect/runtime/src/main/java/org/apache/kafka/connect/runtime/InternalSinkRecord.java,1,2,3 ,"Jul 20, 2023"
1322,connect/runtime/src/test/java/org/apache/kafka/connect/runtime/InternalSinkRecordTest.java,44,0,44 ,"Jul 20, 2023"
1323,bin/kafka-delete-records.sh,1,1,2 ,"Jul 21, 2023"
1324,bin/windows/kafka-delete-records.bat,1,1,2 ,"Jul 21, 2023"
1325,core/src/main/scala/kafka/admin/AdminUtils.scala,1,1,2 ,"Jul 21, 2023"
1326,core/src/main/scala/kafka/admin/DeleteRecordsCommand.scala,0,137,137 ,"Jul 21, 2023"
1327,core/src/main/scala/kafka/admin/LeaderElectionCommand.scala,1,1,2 ,"Jul 21, 2023"
1328,core/src/main/scala/kafka/admin/ReassignPartitionsCommand.scala,1,1,2 ,"Jul 21, 2023"
1329,core/src/main/scala/kafka/admin/TopicCommand.scala,1,1,2 ,"Jul 21, 2023"
1330,core/src/main/scala/kafka/controller/KafkaController.scala,1,2,3 ,"Jul 21, 2023"
1331,core/src/main/scala/kafka/server/ZkAdminManager.scala,2,1,3 ,"Jul 21, 2023"
1332,core/src/main/scala/kafka/zk/AdminZkClient.scala,2,1,3 ,"Jul 21, 2023"
1333,core/src/test/scala/unit/kafka/admin/AddPartitionsTest.scala,1,0,1,"Jul 21, 2023"
1334,core/src/test/scala/unit/kafka/admin/LeaderElectionCommandErrorTest.scala,1,1,2 ,"Jul 21, 2023"
1335,core/src/test/scala/unit/kafka/admin/LeaderElectionCommandTest.scala,1,2,3 ,"Jul 21, 2023"
1336,core/src/test/scala/unit/kafka/admin/ReassignPartitionsUnitTest.scala,1,1,2 ,"Jul 21, 2023"
1337,core/src/test/scala/unit/kafka/admin/TopicCommandTest.scala,1,1,2 ,"Jul 21, 2023"
1338,core/src/test/scala/unit/kafka/server/DynamicConfigTest.scala,1,1,2 ,"Jul 21, 2023"
1339,core/src/test/scala/unit/kafka/zk/AdminZkClientTest.scala,1,0,1,"Jul 21, 2023"
1340,build.gradle,1,0,1,"Jul 18, 2023"
1341,checkstyle/import-control-core.xml,1,0,1,"Jul 18, 2023"
1342,checkstyle/import-control.xml,1,0,1,"Jul 18, 2023"
1343,checkstyle/suppressions.xml,1,1,2 ,"Jul 18, 2023"
1344,core/src/main/java/kafka/log/remote/RemoteLogManager.java,44,7,51 ,"Jul 18, 2023"
1345,core/src/main/java/kafka/log/remote/RemoteLogReader.java,11,1,12 ,"Jul 18, 2023"
1346,core/src/main/scala/kafka/log/UnifiedLog.scala,1,1,2 ,"Jul 18, 2023"
1347,core/src/main/scala/kafka/server/BrokerServer.scala,1,1,2 ,"Jul 18, 2023"
1348,core/src/main/scala/kafka/server/KafkaRequestHandler.scala,30,0,30 ,"Jul 18, 2023"
1349,core/src/main/scala/kafka/server/KafkaServer.scala,1,1,2 ,"Jul 18, 2023"
1350,connect/runtime/src/test/java/org/apache/kafka/connect/runtime/distributed/DistributedConfigTest.java,9,2,11 ,"Jul 19, 2023"
1351,core/src/test/scala/unit/kafka/server/ReplicaManagerTest.scala,2,2,4 ,"Jul 21, 2023"
1352,core/src/test/scala/unit/kafka/utils/TestUtils.scala,1,1,2 ,"Jul 21, 2023"
1353,tools/src/main/java/org/apache/kafka/tools/ConsumerPerformance.java,0,1,1,"Jul 21, 2023"
1354,tools/src/main/java/org/apache/kafka/tools/MetadataQuorumCommand.java,0,1,1,"Jul 21, 2023"
1355,tools/src/main/java/org/apache/kafka/tools/ProducerPerformance.java,0,1,1,"Jul 21, 2023"
1356,gradle/dependencies.gradle,1,1,2 ,"Jul 21, 2023"
1357,metadata/src/main/java/org/apache/kafka/image/writer/ImageWriterOptions.java,16,3,19 ,"Jul 24, 2023"
1358,metadata/src/test/java/org/apache/kafka/image/ImageDowngradeTest.java,1,1,2 ,"Jul 24, 2023"
1359,metadata/src/test/java/org/apache/kafka/image/writer/ImageWriterOptionsTest.java,21,0,21 ,"Jul 24, 2023"
1360,streams/src/main/java/org/apache/kafka/streams/kstream/internals/KStreamImpl.java,3,2,5 ,"Jul 20, 2023"
1361,streams/src/main/java/org/apache/kafka/streams/kstream/internals/graph/StreamTableJoinNode.java,16,1,17 ,"Jul 20, 2023"
1362,streams/src/main/java/org/apache/kafka/streams/processor/internals/InternalTopologyBuilder.java,9,0,9 ,"Jul 20, 2023"
1363,streams/src/test/java/org/apache/kafka/streams/kstream/internals/KStreamKTableJoinTest.java,70,0,70 ,"Jul 20, 2023"
1364,checkstyle/suppressions.xml,7,5,12 ,"Jul 19, 2023"
1365,clients/src/main/java/org/apache/kafka/common/requests/JoinGroupRequest.java,62,0,62 ,"Jul 19, 2023"
1366,core/src/main/scala/kafka/server/BrokerServer.scala,6,1,7 ,"Jul 19, 2023"
1367,group-coordinator/src/main/java/org/apache/kafka/coordinator/group/GroupCoordinatorConfig.java,41,1,42 ,"Jul 19, 2023"
1368,group-coordinator/src/main/java/org/apache/kafka/coordinator/group/GroupCoordinatorService.java,35,5,40 ,"Jul 19, 2023"
1369,clients/src/main/java/org/apache/kafka/clients/consumer/internals/CommitRequestManager.java,1,1,2 ,"Jul 21, 2023"
1370,clients/src/main/java/org/apache/kafka/clients/consumer/internals/ConsumerCoordinator.java,1,1,2 ,"Jul 21, 2023"
1371,clients/src/main/java/org/apache/kafka/common/errors/StaleMemberEpochException.java,32,0,32 ,"Jul 21, 2023"
1372,clients/src/main/java/org/apache/kafka/common/protocol/Errors.java,3,1,4 ,"Jul 21, 2023"
1373,clients/src/main/java/org/apache/kafka/common/requests/AbstractRequest.java,8,1,9 ,"Jul 21, 2023"
1374,clients/src/main/java/org/apache/kafka/common/requests/ConsumerGroupHeartbeatRequest.java,5,1,6 ,"Jul 21, 2023"
1375,clients/src/main/java/org/apache/kafka/common/requests/OffsetCommitRequest.java,24,25,49 ,"Jul 21, 2023"
1376,clients/src/main/resources/common/message/OffsetCommitRequest.json,9,3,12 ,"Jul 21, 2023"
1377,clients/src/main/resources/common/message/OffsetCommitResponse.json,14,1,15 ,"Jul 21, 2023"
1378,clients/src/test/java/org/apache/kafka/clients/consumer/internals/ConsumerCoordinatorTest.java,1,1,2 ,"Jul 21, 2023"
1379,clients/src/test/java/org/apache/kafka/common/message/MessageTest.java,2,2,4 ,"Jul 21, 2023"
1380,clients/src/test/java/org/apache/kafka/common/requests/OffsetCommitRequestTest.java,22,20,42 ,"Jul 21, 2023"
1381,clients/src/test/java/org/apache/kafka/common/requests/RequestResponseTest.java,1,1,2 ,"Jul 21, 2023"
1382,core/src/main/scala/kafka/coordinator/group/GroupCoordinatorAdapter.scala,1,1,2 ,"Jul 21, 2023"
1383,core/src/main/scala/kafka/server/KafkaApis.scala,1,1,2 ,"Jul 21, 2023"
1384,core/src/test/scala/integration/kafka/api/AuthorizerIntegrationTest.scala,2,1,3 ,"Jul 21, 2023"
1385,core/src/test/scala/unit/kafka/coordinator/group/GroupCoordinatorAdapterTest.scala,2,2,4 ,"Jul 21, 2023"
1386,gradle/dependencies.gradle,1,1,2 ,"Jul 19, 2023"
1387,gradle/wrapper/gradle-wrapper.properties,2,2,4 ,"Jul 19, 2023"
1388,gradlew,1,1,2 ,"Jul 19, 2023"
1389,docs/toc.html,2,1,3 ,"Jul 20, 2023"
1390,docs/ops.html,17,1,18 ,"Jul 18, 2023"
1391,connect/api/src/main/java/org/apache/kafka/connect/source/SourceTask.java,4,3,7 ,"Jul 18, 2023"
1392,clients/src/main/java/org/apache/kafka/clients/consumer/internals/CommitRequestManager.java,3,4,7 ,"Jul 21, 2023"
1393,clients/src/main/java/org/apache/kafka/clients/consumer/internals/DefaultBackgroundThread.java,18,6,24 ,"Jul 21, 2023"
1394,clients/src/main/java/org/apache/kafka/clients/consumer/internals/DefaultEventHandler.java,3,0,3 ,"Jul 21, 2023"
1395,clients/src/main/java/org/apache/kafka/clients/consumer/internals/PrototypeAsyncConsumer.java,31,2,33 ,"Jul 21, 2023"
1396,clients/src/main/java/org/apache/kafka/clients/consumer/internals/events/ApplicationEvent.java,1,1,2 ,"Jul 21, 2023"
1397,clients/src/main/java/org/apache/kafka/clients/consumer/internals/events/ApplicationEventProcessor.java,27,3,30 ,"Jul 21, 2023"
1398,clients/src/main/java/org/apache/kafka/clients/consumer/internals/events/AssignmentChangeApplicationEvent.java,33,0,33 ,"Jul 21, 2023"
1399,clients/src/main/java/org/apache/kafka/clients/consumer/internals/events/NewTopicsMetadataUpdateRequestEvent.java,24,0,24 ,"Jul 21, 2023"
1400,clients/src/test/java/org/apache/kafka/clients/consumer/internals/CommitRequestManagerTest.java,1,1,2 ,"Jul 21, 2023"
1401,streams/src/main/java/org/apache/kafka/streams/processor/internals/assignment/Graph.java,377,0,377 ,"Jul 20, 2023"
1402,checkstyle/suppressions.xml,1,1,2 ,"Jul 21, 2023"
1403,core/src/test/java/kafka/log/remote/RemoteLogManagerTest.java,80,0,80 ,"Jul 21, 2023"
1404,connect/runtime/src/main/java/org/apache/kafka/connect/runtime/isolation/PluginScanner.java,59,11,70 ,"Jul 19, 2023"
1405,connect/runtime/src/main/java/org/apache/kafka/connect/runtime/isolation/PluginSource.java,3,1,4 ,"Jul 19, 2023"
1406,connect/runtime/src/main/java/org/apache/kafka/connect/runtime/isolation/PluginUtils.java,1,1,2 ,"Jul 19, 2023"
1407,connect/runtime/src/main/java/org/apache/kafka/connect/runtime/isolation/ReflectionScanner.java,29,25,54 ,"Jul 19, 2023"
1408,connect/runtime/src/main/java/org/apache/kafka/connect/runtime/isolation/ServiceLoaderScanner.java,80,0,80 ,"Jul 19, 2023"
1409,release.py,16,8,24 ,"Jul 19, 2023"
1410,storage/src/main/java/org/apache/kafka/server/log/remote/metadata/storage/RemoteLogLeaderEpochState.java,18,6,24 ,"Jul 24, 2023"
1411,storage/src/test/java/org/apache/kafka/server/log/remote/metadata/storage/RemoteLogLeaderEpochStateTest.java,206,0,206 ,"Jul 24, 2023"
1412,core/src/main/scala/kafka/server/DelayedProduce.scala,7,2,9 ,"Jul 19, 2023"
1413,core/src/main/scala/kafka/server/FetchSession.scala,21,0,21 ,"Jul 19, 2023"
1414,connect/api/src/main/java/org/apache/kafka/connect/sink/SinkTaskContext.java,1,1,2 ,"Jul 19, 2023"
1415,connect/api/src/main/java/org/apache/kafka/connect/source/SourceTaskContext.java,1,1,2 ,"Jul 19, 2023"
1416,checkstyle/import-control.xml,1,0,1,"Jul 21, 2023"
1417,connect/api/src/main/java/org/apache/kafka/connect/sink/SinkRecord.java,136,8,144 ,"Jul 21, 2023"
1418,connect/api/src/main/java/org/apache/kafka/connect/sink/SinkTask.java,28,9,37 ,"Jul 21, 2023"
1419,connect/api/src/test/java/org/apache/kafka/connect/sink/SinkRecordTest.java,34,2,36 ,"Jul 21, 2023"
1420,checkstyle/import-control.xml,0,4,4 ,"Jul 20, 2023"
1421,streams/src/test/java/org/apache/kafka/streams/integration/AbstractResetIntegrationTest.java,1,1,2 ,"Jul 20, 2023"
1422,streams/src/test/java/org/apache/kafka/streams/integration/ResetIntegrationTest.java,5,5,10 ,"Jul 20, 2023"
1423,README.md,1,1,2 ,"Jul 21, 2023"
1424,storage/src/main/java/org/apache/kafka/server/log/remote/metadata/storage/ConsumerManager.java,23,10,33 ,"Jul 22, 2023"
1425,storage/src/main/java/org/apache/kafka/server/log/remote/metadata/storage/ConsumerTask.java,12,3,15 ,"Jul 22, 2023"
1426,storage/src/main/java/org/apache/kafka/server/log/remote/metadata/storage/TopicBasedRemoteLogMetadataManager.java,11,25,36 ,"Jul 22, 2023"
1427,storage/src/main/java/org/apache/kafka/server/log/remote/metadata/storage/TopicBasedRemoteLogMetadataManagerConfig.java,8,0,8 ,"Jul 22, 2023"
1428,storage/src/test/java/org/apache/kafka/server/log/remote/metadata/storage/RemoteLogSegmentLifecycleTest.java,5,3,8 ,"Jul 22, 2023"
1429,licenses/classgraph-MIT,0,21,21 ,"Jul 20, 2023"
1430,LICENSE-binary,2,1,3 ,"Jul 19, 2023"
1431,connect/runtime/src/main/java/org/apache/kafka/connect/runtime/isolation/ReflectionScanner.java,4,27,31 ,"Jul 19, 2023"
1432,gradle/dependencies.gradle,1,1,2 ,"Jul 19, 2023"
1433,storage/src/main/java/org/apache/kafka/storage/internals/log/LogFileUtils.java,1,1,2 ,"Jul 22, 2023"
1434,storage/src/test/java/org/apache/kafka/server/log/remote/storage/LocalTieredStorage.java,17,17,34 ,"Jul 22, 2023"
1435,storage/src/test/java/org/apache/kafka/server/log/remote/storage/LocalTieredStorageTest.java,41,36,77 ,"Jul 22, 2023"
1436,storage/src/test/java/org/apache/kafka/server/log/remote/storage/RemoteLogSegmentFileset.java,18,16,34 ,"Jul 22, 2023"
1437,checkstyle/import-control.xml,1,0,1,"Jul 21, 2023"
1438,group-coordinator/src/main/java/org/apache/kafka/coordinator/group/OffsetAndMetadata.java,125,0,125 ,"Jul 21, 2023"
1439,group-coordinator/src/main/java/org/apache/kafka/coordinator/group/RecordHelpers.java,69,0,69 ,"Jul 21, 2023"
1440,group-coordinator/src/test/java/org/apache/kafka/coordinator/group/OffsetAndMetadataTest.java,74,0,74 ,"Jul 21, 2023"
1441,streams/src/test/java/org/apache/kafka/streams/processor/internals/TaskManagerTest.java,41,56,97 ,"Jul 20, 2023"
1442,connect/runtime/src/main/java/org/apache/kafka/connect/runtime/isolation/PluginUtils.java,4,2,6 ,"Jul 19, 2023"
1443,connect/runtime/src/test/java/org/apache/kafka/connect/runtime/isolation/PluginsTest.java,6,1,7 ,"Jul 19, 2023"
1444,connect/runtime/src/test/resources/test-plugins/read-version-from-resource-v1/test/plugins/ReadVersionFromResource.java,11,1,12 ,"Jul 19, 2023"
1445,connect/runtime/src/test/resources/test-plugins/read-version-from-resource-v2/test/plugins/ReadVersionFromResource.java,11,1,12 ,"Jul 19, 2023"
1446,build.gradle,0,2,2 ,"Jul 20, 2023"
1447,checkstyle/import-control.xml,0,2,2 ,"Jul 20, 2023"
1448,connect/api/src/main/java/org/apache/kafka/connect/sink/SinkRecord.java,1,1,2 ,"Jul 20, 2023"
1449,connect/runtime/src/main/java/org/apache/kafka/connect/runtime/InternalSinkRecord.java,1,2,3 ,"Jul 20, 2023"
1450,connect/runtime/src/test/java/org/apache/kafka/connect/runtime/InternalSinkRecordTest.java,44,0,44 ,"Jul 20, 2023"
1451,bin/kafka-delete-records.sh,1,1,2 ,"Jul 21, 2023"
1452,bin/windows/kafka-delete-records.bat,1,1,2 ,"Jul 21, 2023"
1453,core/src/main/scala/kafka/admin/AdminUtils.scala,1,1,2 ,"Jul 21, 2023"
1454,core/src/main/scala/kafka/admin/DeleteRecordsCommand.scala,0,137,137 ,"Jul 21, 2023"
1455,core/src/main/scala/kafka/admin/LeaderElectionCommand.scala,1,1,2 ,"Jul 21, 2023"
1456,core/src/main/scala/kafka/admin/ReassignPartitionsCommand.scala,1,1,2 ,"Jul 21, 2023"
1457,core/src/main/scala/kafka/admin/TopicCommand.scala,1,1,2 ,"Jul 21, 2023"
1458,core/src/main/scala/kafka/controller/KafkaController.scala,1,2,3 ,"Jul 21, 2023"
1459,core/src/main/scala/kafka/server/ZkAdminManager.scala,2,1,3 ,"Jul 21, 2023"
1460,core/src/main/scala/kafka/zk/AdminZkClient.scala,2,1,3 ,"Jul 21, 2023"
1461,core/src/test/scala/unit/kafka/admin/AddPartitionsTest.scala,1,0,1,"Jul 21, 2023"
1462,core/src/test/scala/unit/kafka/admin/LeaderElectionCommandErrorTest.scala,1,1,2 ,"Jul 21, 2023"
1463,core/src/test/scala/unit/kafka/admin/LeaderElectionCommandTest.scala,1,2,3 ,"Jul 21, 2023"
1464,core/src/test/scala/unit/kafka/admin/ReassignPartitionsUnitTest.scala,1,1,2 ,"Jul 21, 2023"
1465,core/src/test/scala/unit/kafka/admin/TopicCommandTest.scala,1,1,2 ,"Jul 21, 2023"
1466,core/src/test/scala/unit/kafka/server/DynamicConfigTest.scala,1,1,2 ,"Jul 21, 2023"
1467,core/src/test/scala/unit/kafka/zk/AdminZkClientTest.scala,1,0,1,"Jul 21, 2023"
1468,build.gradle,1,0,1,"Jul 18, 2023"
1469,checkstyle/import-control-core.xml,1,0,1,"Jul 18, 2023"
1470,checkstyle/import-control.xml,1,0,1,"Jul 18, 2023"
1471,checkstyle/suppressions.xml,1,1,2 ,"Jul 18, 2023"
1472,core/src/main/java/kafka/log/remote/RemoteLogManager.java,44,7,51 ,"Jul 18, 2023"
1473,core/src/main/java/kafka/log/remote/RemoteLogReader.java,11,1,12 ,"Jul 18, 2023"
1474,core/src/main/scala/kafka/log/UnifiedLog.scala,1,1,2 ,"Jul 18, 2023"
1475,core/src/main/scala/kafka/server/BrokerServer.scala,1,1,2 ,"Jul 18, 2023"
1476,core/src/main/scala/kafka/server/KafkaRequestHandler.scala,30,0,30 ,"Jul 18, 2023"
1477,core/src/main/scala/kafka/server/KafkaServer.scala,1,1,2 ,"Jul 18, 2023"
1478,connect/runtime/src/test/java/org/apache/kafka/connect/runtime/distributed/DistributedConfigTest.java,9,2,11 ,"Jul 19, 2023"
1479,core/src/test/scala/unit/kafka/server/ReplicaManagerTest.scala,2,2,4 ,"Jul 21, 2023"
1480,core/src/test/scala/unit/kafka/utils/TestUtils.scala,1,1,2 ,"Jul 21, 2023"
1481,clients/src/main/java/org/apache/kafka/clients/consumer/ConsumerConfig.java,8,1,9 ,"Jul 14, 2023"
1482,build.gradle,0,2,2 ,"Jul 12, 2023"
1483,settings.gradle,34,0,34 ,"Jul 12, 2023"
1484,clients/src/test/java/org/apache/kafka/common/utils/ChunkedBytesStreamTest.java,50,0,50 ,"Jul 15, 2023"
1485,checkstyle/import-control-server-common.xml,2,0,2 ,"Jul 14, 2023"
1486,core/src/main/scala/kafka/server/BrokerServer.scala,52,10,62 ,"Jul 14, 2023"
1487,core/src/main/scala/kafka/server/KafkaConfig.scala,3,2,5 ,"Jul 14, 2023"
1488,core/src/test/scala/unit/kafka/server/ConsumerGroupHeartbeatRequestTest.scala,85,7,92 ,"Jul 14, 2023"
1489,group-coordinator/src/main/java/org/apache/kafka/coordinator/group/GroupCoordinatorService.java,4,2,6 ,"Jul 14, 2023"
1490,group-coordinator/src/main/java/org/apache/kafka/coordinator/group/GroupMetadataManager.java,16,14,30 ,"Jul 14, 2023"
1491,group-coordinator/src/main/java/org/apache/kafka/coordinator/group/runtime/CoordinatorRuntime.java,1,1,2 ,"Jul 14, 2023"
1492,group-coordinator/src/main/java/org/apache/kafka/coordinator/group/util/SystemTimerReaper.java,81,0,81 ,"Jul 14, 2023"
1493,core/src/test/scala/integration/kafka/api/BaseConsumerTest.scala,2,2,4 ,"Jul 14, 2023"
1494,core/src/test/scala/integration/kafka/api/BaseProducerSendTest.scala,2,2,4 ,"Jul 14, 2023"
1495,core/src/test/scala/integration/kafka/api/BaseQuotaTest.scala,2,2,4 ,"Jul 14, 2023"
1496,core/src/test/scala/integration/kafka/api/CustomQuotaCallbackTest.scala,2,2,4 ,"Jul 14, 2023"
1497,core/src/test/scala/integration/kafka/api/IntegrationTestHarness.scala,1,1,2 ,"Jul 14, 2023"
1498,core/src/test/scala/integration/kafka/api/MetricsTest.scala,2,2,4 ,"Jul 14, 2023"
1499,core/src/test/scala/integration/kafka/api/PlaintextAdminIntegrationTest.scala,3,3,6 ,"Jul 14, 2023"
1500,core/src/test/scala/integration/kafka/api/ProducerIdExpirationTest.scala,2,2,4 ,"Jul 14, 2023"
1501,core/src/test/scala/integration/kafka/api/SaslClientsWithInvalidCredentialsTest.scala,2,2,4 ,"Jul 14, 2023"
1502,core/src/test/scala/integration/kafka/api/TransactionsBounceTest.scala,2,2,4 ,"Jul 14, 2023"
1503,core/src/test/scala/integration/kafka/api/TransactionsExpirationTest.scala,2,2,4 ,"Jul 14, 2023"
1504,core/src/test/scala/integration/kafka/api/TransactionsTest.scala,4,4,8 ,"Jul 14, 2023"
1505,core/src/test/scala/integration/kafka/api/TransactionsWithMaxInFlightOneTest.scala,2,2,4 ,"Jul 14, 2023"
1506,core/src/test/scala/integration/kafka/server/DynamicBrokerReconfigurationTest.scala,7,7,14 ,"Jul 14, 2023"
1507,core/src/test/scala/integration/kafka/server/MultipleListenersWithSameSecurityProtocolBaseTest.scala,2,2,4 ,"Jul 14, 2023"
1508,connect/mirror/src/main/java/org/apache/kafka/connect/mirror/MirrorCheckpointConnector.java,10,12,22 ,"Jul 10, 2023"
1509,connect/mirror/src/test/java/org/apache/kafka/connect/mirror/MirrorCheckpointConnectorTest.java,16,14,30 ,"Jul 10, 2023"
1510,tools/src/main/java/org/apache/kafka/tools/JmxTool.java,1,1,2 ,"Jul 12, 2023"
1511,tools/src/test/java/org/apache/kafka/tools/JmxToolTest.java,13,0,13 ,"Jul 12, 2023"
1512,.asf.yaml,50,17,67 ,"Jul 18, 2023"
1513,connect/mirror/src/main/java/org/apache/kafka/connect/mirror/MirrorSourceConnector.java,3,3,6 ,"Jul 12, 2023"
1514,.asf.yaml,17,50,67 ,"Jul 18, 2023"
1515,clients/src/main/java/org/apache/kafka/clients/producer/internals/Sender.java,9,10,19 ,"Jul 14, 2023"
1516,clients/src/main/java/org/apache/kafka/clients/producer/internals/TransactionManager.java,5,0,5 ,"Jul 14, 2023"
1517,clients/src/test/java/org/apache/kafka/clients/MockClient.java,6,1,7 ,"Jul 14, 2023"
1518,clients/src/test/java/org/apache/kafka/clients/producer/internals/SenderTest.java,50,0,50 ,"Jul 14, 2023"
1519,core/src/main/scala/kafka/cluster/Partition.scala,8,4,12 ,"Jul 14, 2023"
1520,core/src/main/scala/kafka/log/UnifiedLog.scala,58,5,63 ,"Jul 14, 2023"
1521,tests/kafkatest/tests/client/client_compatibility_features_test.py,3,1,4 ,"Jul 12, 2023"
1522,tests/kafkatest/tests/client/client_compatibility_produce_consume_test.py,3,1,4 ,"Jul 12, 2023"
1523,tests/kafkatest/tests/core/compatibility_test_new_broker_test.py,3,1,4 ,"Jul 12, 2023"
1524,tests/kafkatest/tests/core/downgrade_test.py,7,1,8 ,"Jul 12, 2023"
1525,tests/kafkatest/tests/core/upgrade_test.py,7,1,8 ,"Jul 12, 2023"
1526,docs/streams/upgrade-guide.html,53,0,53 ,"Jul 11, 2023"
1527,core/src/test/scala/integration/kafka/api/ConsumerBounceTest.scala,59,46,105 ,"Jul 14, 2023"
1528,gradle/dependencies.gradle,4,0,4 ,"Jul 12, 2023"
1529,tests/docker/Dockerfile,5,2,7 ,"Jul 12, 2023"
1530,tests/kafkatest/version.py,2,1,3 ,"Jul 12, 2023"
1531,vagrant/base.sh,4,0,4 ,"Jul 12, 2023"
1532,kafka-merge-pr.py,1,1,2 ,"Jul 11, 2023"
1533,release.py,1,1,2 ,"Jul 11, 2023"
1534,reviewers.py,3,3,6 ,"Jul 11, 2023"
1535,tests/kafkatest/benchmarks/core/benchmark_test.py,1,1,2 ,"Jul 11, 2023"
1536,tests/kafkatest/services/connect.py,2,2,4 ,"Jul 11, 2023"
1537,tests/kafkatest/services/kafka/kafka.py,2,2,4 ,"Jul 11, 2023"
1538,tests/kafkatest/services/monitor/http.py,2,2,4 ,"Jul 11, 2023"
1539,tests/kafkatest/services/monitor/jmx.py,1,1,2 ,"Jul 11, 2023"
1540,tests/kafkatest/services/streams.py,1,1,2 ,"Jul 11, 2023"
1541,tests/kafkatest/services/transactional_message_copier.py,1,1,2 ,"Jul 11, 2023"
1542,tests/kafkatest/services/trogdor/kibosh.py,4,4,8 ,"Jul 11, 2023"
1543,tests/kafkatest/services/trogdor/trogdor.py,2,2,4 ,"Jul 11, 2023"
1544,tests/kafkatest/tests/connect/connect_distributed_test.py,1,1,2 ,"Jul 11, 2023"
1545,tests/kafkatest/tests/connect/connect_rest_test.py,1,1,2 ,"Jul 11, 2023"
1546,tests/kafkatest/tests/core/get_offset_shell_test.py,1,1,2 ,"Jul 11, 2023"
1547,tests/kafkatest/tests/core/group_mode_transactions_test.py,2,2,4 ,"Jul 11, 2023"
1548,tests/kafkatest/tests/core/replication_test.py,2,2,4 ,"Jul 11, 2023"
1549,tests/kafkatest/tests/core/snapshot_test.py,1,1,2 ,"Jul 11, 2023"
1550,tests/kafkatest/tests/core/transactions_test.py,2,2,4 ,"Jul 11, 2023"
1551,tests/kafkatest/tests/streams/streams_broker_bounce_test.py,1,1,2 ,"Jul 11, 2023"
1552,tests/kafkatest/tests/streams/streams_relational_smoke_test.py,1,1,2 ,"Jul 11, 2023"
1553,connect/file/src/main/java/org/apache/kafka/connect/file/FileStreamSinkConnector.java,8,0,8 ,"Jul 18, 2023"
1554,connect/file/src/main/java/org/apache/kafka/connect/file/FileStreamSourceConnector.java,49,0,49 ,"Jul 18, 2023"
1555,connect/file/src/test/java/org/apache/kafka/connect/file/FileStreamSourceConnectorTest.java,84,4,88 ,"Jul 18, 2023"
1556,connect/runtime/src/main/java/org/apache/kafka/connect/runtime/Worker.java,34,4,38 ,"Jul 14, 2023"
1557,connect/runtime/src/test/java/org/apache/kafka/connect/runtime/WorkerTest.java,34,6,40 ,"Jul 14, 2023"
1558,build.gradle,3,2,5 ,"Jul 11, 2023"
1559,checkstyle/import-control.xml,1,0,1,"Jul 11, 2023"
1560,checkstyle/suppressions.xml,1,1,2 ,"Jul 11, 2023"
1561,core/src/main/java/kafka/log/remote/RemoteLogManager.java,3,1,4 ,"Jul 11, 2023"
1562,core/src/main/scala/kafka/log/LocalLog.scala,1,1,2 ,"Jul 11, 2023"
1563,core/src/main/scala/kafka/log/LogManager.scala,2,4,6 ,"Jul 11, 2023"
1564,connect/runtime/src/test/java/org/apache/kafka/connect/integration/StartAndStopCounterTest.java,3,0,3 ,"Jul 12, 2023"
1565,connect/runtime/src/test/java/org/apache/kafka/connect/integration/StartAndStopLatchTest.java,3,0,3 ,"Jul 12, 2023"
1566,streams/src/test/java/org/apache/kafka/streams/integration/KTableEfficientRangeQueryTest.java,3,0,3 ,"Jul 12, 2023"
1567,streams/src/test/java/org/apache/kafka/streams/integration/KTableKTableForeignKeyInnerJoinMultiIntegrationTest.java,2,3,5 ,"Jul 12, 2023"
1568,streams/src/test/java/org/apache/kafka/streams/integration/KTableKTableForeignKeyJoinDistributedTest.java,2,3,5 ,"Jul 12, 2023"
1569,streams/src/test/java/org/apache/kafka/streams/integration/LagFetchIntegrationTest.java,2,3,5 ,"Jul 12, 2023"
1570,streams/src/test/java/org/apache/kafka/streams/integration/MetricsIntegrationTest.java,2,3,5 ,"Jul 12, 2023"
1571,streams/src/test/java/org/apache/kafka/streams/integration/MetricsReporterIntegrationTest.java,2,3,5 ,"Jul 12, 2023"
1572,streams/src/test/java/org/apache/kafka/streams/integration/NamedTopologyIntegrationTest.java,2,3,5 ,"Jul 12, 2023"
1573,streams/src/test/java/org/apache/kafka/streams/integration/OptimizedKTableIntegrationTest.java,2,3,5 ,"Jul 12, 2023"
1574,streams/src/test/java/org/apache/kafka/streams/integration/PurgeRepartitionTopicIntegrationTest.java,2,3,5 ,"Jul 12, 2023"
1575,streams/src/test/java/org/apache/kafka/streams/integration/QueryableStateIntegrationTest.java,2,3,5 ,"Jul 12, 2023"
1576,streams/src/test/java/org/apache/kafka/streams/integration/RegexSourceIntegrationTest.java,2,3,5 ,"Jul 12, 2023"
1577,streams/src/test/java/org/apache/kafka/streams/integration/StandbyTaskCreationIntegrationTest.java,2,3,5 ,"Jul 12, 2023"
1578,storage/src/test/java/org/apache/kafka/server/log/remote/storage/LocalTieredStorage.java,576,0,576 ,"Jul 17, 2023"
1579,storage/src/test/java/org/apache/kafka/server/log/remote/storage/LocalTieredStorageCondition.java,220,0,220 ,"Jul 17, 2023"
1580,build.gradle,1,0,1,"Jul 18, 2023"
1581,checkstyle/import-control-server-common.xml,2,0,2 ,"Jul 18, 2023"
1582,server-common/src/main/java/org/apache/kafka/server/util/Json.java,107,0,107 ,"Jul 18, 2023"
1583,server-common/src/main/java/org/apache/kafka/server/util/json/DecodeJson.java,127,0,127 ,"Jul 18, 2023"
1584,server-common/src/main/java/org/apache/kafka/server/util/json/JsonArray.java,67,0,67 ,"Jul 18, 2023"
1585,connect/runtime/src/main/java/org/apache/kafka/connect/storage/KafkaStatusBackingStore.java,19,0,19 ,"Jul 11, 2023"
1586,connect/runtime/src/test/java/org/apache/kafka/connect/storage/KafkaStatusBackingStoreTest.java,52,0,52 ,"Jul 11, 2023"
1587,LICENSE-binary,10,10,20 ,"Jul 11, 2023"
1588,gradle/dependencies.gradle,5,4,9 ,"Jul 11, 2023"
1589,group-coordinator/src/main/java/org/apache/kafka/coordinator/group/GroupMetadataManager.java,214,30,244 ,"Jul 12, 2023"
1590,group-coordinator/src/main/java/org/apache/kafka/coordinator/group/ReplicatedGroupCoordinator.java,1,0,1,"Jul 12, 2023"
1591,group-coordinator/src/main/java/org/apache/kafka/coordinator/group/runtime/CoordinatorResult.java,11,0,11 ,"Jul 12, 2023"
1592,group-coordinator/src/main/java/org/apache/kafka/coordinator/group/runtime/CoordinatorRuntime.java,2,2,4 ,"Jul 12, 2023"
1593,checkstyle/import-control-server-common.xml,1,0,1,"Jul 18, 2023"
1594,core/src/main/scala/kafka/admin/TopicCommand.scala,2,1,3 ,"Jul 18, 2023"
1595,core/src/main/scala/kafka/tools/ConsoleConsumer.scala,0,1,1,"Jul 18, 2023"
1596,core/src/main/scala/kafka/tools/GetOffsetShell.scala,19,72,91 ,"Jul 18, 2023"
1597,core/src/main/scala/kafka/tools/MirrorMaker.scala,2,2,4 ,"Jul 18, 2023"
1598,core/src/main/scala/kafka/tools/ReplicaVerificationTool.scala,2,1,3 ,"Jul 18, 2023"
1599,core/src/main/scala/kafka/utils/TopicFilter.scala,0,55,55 ,"Jul 18, 2023"
1600,core/src/test/scala/unit/kafka/utils/TopicFilterTest.scala,0,49,49 ,"Jul 18, 2023"
1601,server-common/src/main/java/org/apache/kafka/server/util/PartitionFilter.java,66,0,66 ,"Jul 18, 2023"
1602,core/src/main/scala/kafka/server/ControllerServer.scala,2,1,3 ,"Jul 14, 2023"
1603,core/src/test/scala/integration/kafka/server/KafkaServerKRaftRegistrationTest.scala,16,7,23 ,"Jul 14, 2023"
1604,metadata/src/main/java/org/apache/kafka/metadata/migration/KRaftMigrationDriver.java,58,48,106 ,"Jul 14, 2023"
1605,core/src/main/scala/kafka/server/ControllerServer.scala,3,2,5 ,"Jul 17, 2023"
1606,metadata/src/main/java/org/apache/kafka/controller/QuorumController.java,1,1,2 ,"Jul 17, 2023"
1607,metadata/src/main/java/org/apache/kafka/controller/metrics/QuorumControllerMetrics.java,27,2,29 ,"Jul 17, 2023"
1608,metadata/src/main/java/org/apache/kafka/metadata/migration/KRaftMigrationDriver.java,10,2,12 ,"Jul 17, 2023"
1609,metadata/src/test/java/org/apache/kafka/controller/QuorumControllerTest.java,1,1,2 ,"Jul 17, 2023"
1610,metadata/src/test/java/org/apache/kafka/controller/metrics/QuorumControllerMetricsTest.java,61,5,66 ,"Jul 17, 2023"
1611,metadata/src/test/java/org/apache/kafka/metadata/migration/KRaftMigrationDriverTest.java,33,11,44 ,"Jul 17, 2023"
1612,docs/streams/developer-guide/dsl-api.html,1,1,2 ,"Jul 16, 2023"
1613,metadata/src/test/java/org/apache/kafka/controller/ReplicationControlManagerTest.java,1,1,2 ,"Jul 14, 2023"
1614,streams/src/main/java/org/apache/kafka/streams/processor/internals/tasks/DefaultTaskExecutor.java,13,1,14 ,"Jul 13, 2023"
1615,streams/src/main/java/org/apache/kafka/streams/processor/internals/tasks/DefaultTaskManager.java,36,0,36 ,"Jul 13, 2023"
1616,streams/src/main/java/org/apache/kafka/streams/processor/internals/tasks/TaskManager.java,23,0,23 ,"Jul 13, 2023"
1617,streams/src/test/java/org/apache/kafka/streams/processor/internals/tasks/DefaultTaskExecutorTest.java,15,0,15 ,"Jul 13, 2023"
1618,streams/src/test/java/org/apache/kafka/streams/processor/internals/tasks/DefaultTaskManagerTest.java,32,0,32 ,"Jul 13, 2023"
1619,clients/src/main/java/org/apache/kafka/common/requests/AbstractControlRequest.java,12,0,12 ,"Jul 11, 2023"
1620,core/src/main/scala/kafka/controller/ControllerChannelManager.scala,3,1,4 ,"Jul 11, 2023"
1621,connect/runtime/src/test/java/org/apache/kafka/connect/integration/ExactlyOnceSourceIntegrationTest.java,10,7,17 ,"Jul 12, 2023"
1622,connect/runtime/src/test/java/org/apache/kafka/connect/integration/MonitorableSourceConnector.java,4,0,4 ,"Jul 12, 2023"
1623,metadata/src/main/java/org/apache/kafka/controller/AclControlManager.java,47,6,53 ,"Jul 13, 2023"
1624,metadata/src/main/java/org/apache/kafka/controller/ClientQuotaControlManager.java,33,1,34 ,"Jul 13, 2023"
1625,metadata/src/main/java/org/apache/kafka/controller/ClusterControlManager.java,8,4,12 ,"Jul 13, 2023"
1626,metadata/src/main/java/org/apache/kafka/controller/ConfigurationControlManager.java,4,2,6 ,"Jul 13, 2023"
1627,metadata/src/main/java/org/apache/kafka/controller/FeatureControlManager.java,14,7,21 ,"Jul 13, 2023"
1628,metadata/src/main/java/org/apache/kafka/controller/ProducerIdControlManager.java,45,2,47 ,"Jul 13, 2023"
1629,metadata/src/main/java/org/apache/kafka/controller/QuorumController.java,16,5,21 ,"Jul 13, 2023"
1630,examples/src/main/java/kafka/examples/ExactlyOnceMessageProcessor.java,17,2,19 ,"Jul 17, 2023"
1631,examples/src/main/java/kafka/examples/KafkaConsumerProducerDemo.java,5,6,11 ,"Jul 17, 2023"
1632,examples/src/main/java/kafka/examples/KafkaExactlyOnceDemo.java,26,8,34 ,"Jul 17, 2023"
1633,examples/src/main/java/kafka/examples/KafkaProperties.java,1,3,4 ,"Jul 17, 2023"
1634,core/src/test/scala/integration/kafka/zk/ZkMigrationIntegrationTest.scala,16,1,17 ,"Jul 7, 2023"
1635,metadata/src/main/java/org/apache/kafka/metadata/migration/KRaftMigrationZkWriter.java,2,2,4 ,"Jul 7, 2023"
1636,connect/runtime/src/main/java/org/apache/kafka/connect/runtime/AbstractWorkerSourceTask.java,1,0,1,"Jul 10, 2023"
1637,connect/runtime/src/test/java/org/apache/kafka/connect/runtime/AbstractWorkerSourceTaskTest.java,44,6,50 ,"Jul 10, 2023"
1638,connect/runtime/src/main/java/org/apache/kafka/connect/runtime/distributed/DistributedHerder.java,1,1,2 ,"Jun 30, 2023"
1639,connect/runtime/src/main/java/org/apache/kafka/connect/runtime/StateTracker.java,2,6,8 ,"Jun 29, 2023"
1640,core/src/main/scala/kafka/log/remote/RemoteIndexCache.scala,3,1,4 ,"Jul 8, 2023"
1641,connect/mirror/src/main/java/org/apache/kafka/connect/mirror/MirrorMaker.java,12,5,17 ,"Jul 10, 2023"
1642,connect/mirror/src/test/java/org/apache/kafka/connect/mirror/integration/DedicatedMirrorIntegrationTest.java,96,19,115 ,"Jul 10, 2023"
1643,core/src/main/java/kafka/log/remote/RemoteLogManager.java,4,2,6 ,"Jul 3, 2023"
1644,core/src/test/java/kafka/log/remote/RemoteLogManagerTest.java,3,2,5 ,"Jul 3, 2023"
1645,storage/src/test/java/org/apache/kafka/server/log/remote/metadata/storage/TopicBasedRemoteLogMetadataManagerConfigTest.java,4,1,5 ,"Jul 3, 2023"
1646,shell/src/main/java/org/apache/kafka/shell/command/FindCommandHandler.java,4,1,5 ,"Jul 7, 2023"
1647,shell/src/main/java/org/apache/kafka/shell/command/LsCommandHandler.java,1,0,1,"Jul 7, 2023"
1648,shell/src/main/java/org/apache/kafka/shell/state/MetadataShellPublisher.java,4,0,4 ,"Jul 7, 2023"
1649,shell/src/test/java/org/apache/kafka/shell/glob/GlobComponentTest.java,76,0,76 ,"Jul 7, 2023"
1650,shell/src/test/resources/log4j.properties,19,0,19 ,"Jul 7, 2023"
1651,connect/runtime/src/main/java/org/apache/kafka/connect/runtime/isolation/ClassLoaderFactory.java,41,0,41 ,"Jul 6, 2023"
1652,connect/runtime/src/main/java/org/apache/kafka/connect/runtime/isolation/DelegatingClassLoader.java,4,295,299 ,"Jul 6, 2023"
1653,checkstyle/suppressions.xml,1,1,2 ,"Jul 5, 2023"
1654,group-coordinator/src/main/java/org/apache/kafka/coordinator/group/GroupCoordinatorService.java,1,0,1,"Jul 5, 2023"
1655,group-coordinator/src/main/java/org/apache/kafka/coordinator/group/GroupMetadataManager.java,196,27,223 ,"Jul 5, 2023"
1656,core/src/main/java/kafka/log/remote/RemoteLogManager.java,1,1,2 ,"Jul 8, 2023"
1657,core/src/main/scala/kafka/log/remote/RemoteIndexCache.scala,107,43,150 ,"Jul 8, 2023"
1658,checkstyle/import-control-server-common.xml,6,2,8 ,"Jul 6, 2023"
1659,core/src/test/scala/unit/kafka/coordinator/AbstractCoordinatorConcurrencyTest.scala,1,1,2 ,"Jul 6, 2023"
1660,core/src/test/scala/unit/kafka/coordinator/group/GroupCoordinatorTest.scala,1,1,2 ,"Jul 6, 2023"
1661,core/src/test/scala/unit/kafka/server/ReplicaManagerTest.scala,1,1,2 ,"Jul 6, 2023"
1662,core/src/test/scala/unit/kafka/utils/timer/MockTimer.scala,0,72,72 ,"Jul 6, 2023"
1663,server-common/src/test/java/org/apache/kafka/server/util/timer/MockTimer.java,89,0,89 ,"Jul 6, 2023"
1664,checkstyle/suppressions.xml,1,1,2 ,"Jun 29, 2023"
1665,clients/src/main/java/org/apache/kafka/clients/producer/internals/Sender.java,18,2,20 ,"Jun 29, 2023"
1666,clients/src/main/java/org/apache/kafka/clients/producer/internals/TransactionManager.java,78,4,82 ,"Jun 29, 2023"
1667,clients/src/test/java/org/apache/kafka/clients/producer/internals/TransactionManagerTest.java,53,0,53 ,"Jun 29, 2023"
1668,metadata/src/test/java/org/apache/kafka/image/AclsImageTest.java,30,12,42 ,"Jul 10, 2023"
1669,metadata/src/test/java/org/apache/kafka/image/ClientQuotasImageTest.java,30,12,42 ,"Jul 10, 2023"
1670,metadata/src/test/java/org/apache/kafka/image/ClusterImageTest.java,29,12,41 ,"Jul 10, 2023"
1671,metadata/src/test/java/org/apache/kafka/image/ConfigurationsImageTest.java,30,12,42 ,"Jul 10, 2023"
1672,metadata/src/test/java/org/apache/kafka/image/FeaturesImageTest.java,30,12,42 ,"Jul 10, 2023"
1673,clients/src/main/java/org/apache/kafka/clients/producer/ProducerConfig.java,12,14,26 ,"Jul 10, 2023"
1674,streams/src/main/java/org/apache/kafka/streams/processor/internals/InternalTopicManager.java,67,11,78 ,"Jul 10, 2023"
1675,streams/src/main/java/org/apache/kafka/streams/processor/internals/RackAwareTaskAssignor.java,187,0,187 ,"Jul 10, 2023"
1676,streams/src/main/java/org/apache/kafka/streams/StreamsBuilder.java,1,1,2 ,"Jul 7, 2023"
1677,build.gradle,1,1,2 ,"Jul 10, 2023"
1678,tests/spec/connection_stress_test.json,1,1,2 ,"Jul 10, 2023"
1679,tests/spec/external_command.json,1,1,2 ,"Jul 10, 2023"
1680,tests/spec/round_trip.json,1,1,2 ,"Jul 10, 2023"
1681,tests/spec/simple_consume_bench_spec.json,1,1,2 ,"Jul 10, 2023"
1682,tests/spec/simple_produce_bench.json,1,1,2 ,"Jul 10, 2023"
1683,tests/spec/transactional-produce-bench.json,1,1,2 ,"Jul 10, 2023"
1684,docs/connect.html,1,1,2 ,"Jun 29, 2023"
1685,release_notes.py,1,1,2 ,"Jul 6, 2023"
1686,tests/kafkatest/tests/client/consumer_test.py,1,1,2 ,"Jul 6, 2023"
1687,tests/kafkatest/tests/connect/connect_test.py,1,1,2 ,"Jul 6, 2023"
1688,build.gradle,1,2,3 ,"Jul 10, 2023"
1689,connect/runtime/src/main/java/org/apache/kafka/connect/runtime/WorkerSourceTask.java,4,2,6 ,"Jul 10, 2023"
1690,streams/src/main/java/org/apache/kafka/streams/processor/internals/TaskManager.java,21,15,36 ,"Jul 3, 2023"
1691,streams/src/test/java/org/apache/kafka/streams/processor/internals/TaskManagerTest.java,70,0,70 ,"Jul 3, 2023"
1692,clients/src/main/java/org/apache/kafka/clients/admin/KafkaAdminClient.java,9,122,131 ,"Jul 3, 2023"
1693,clients/src/main/java/org/apache/kafka/clients/admin/internals/DeleteRecordsHandler.java,178,0,178 ,"Jul 3, 2023"
1694,core/src/test/scala/integration/kafka/admin/TopicCommandIntegrationTest.scala,65,104,169 ,"Jul 4, 2023"
1695,group-coordinator/src/main/java/org/apache/kafka/coordinator/group/GroupCoordinatorService.java,18,0,18 ,"Jul 7, 2023"
1696,group-coordinator/src/main/java/org/apache/kafka/coordinator/group/GroupMetadataManager.java,19,3,22 ,"Jul 7, 2023"
1697,group-coordinator/src/main/java/org/apache/kafka/coordinator/group/ReplicatedGroupCoordinator.java,26,0,26 ,"Jul 7, 2023"
1698,group-coordinator/src/main/java/org/apache/kafka/coordinator/group/runtime/CoordinatorBuilder.java,23,0,23 ,"Jul 7, 2023"
1699,group-coordinator/src/main/java/org/apache/kafka/coordinator/group/runtime/CoordinatorResult.java,2,2,4 ,"Jul 7, 2023"
1700,connect/runtime/src/main/java/org/apache/kafka/connect/runtime/ConnectMetricsRegistry.java,1,1,2 ,"Jul 6, 2023"
1701,core/src/main/scala/kafka/coordinator/transaction/TransactionMarkerChannelManager.scala,23,4,27 ,"Jul 7, 2023"
1702,core/src/test/scala/unit/kafka/coordinator/transaction/TransactionMarkerChannelManagerTest.scala,23,2,25 ,"Jul 7, 2023"
1703,storage/api/src/main/java/org/apache/kafka/server/log/remote/storage/RemoteStorageManager.java,11,5,16 ,"Jun 30, 2023"
1704,core/src/main/scala/kafka/tools/StorageTool.scala,2,2,4 ,"Jun 29, 2023"
1705,core/src/main/scala/kafka/log/LogCleanerManager.scala,12,9,21 ,"Jul 7, 2023"
1706,core/src/test/scala/unit/kafka/log/LogCleanerTest.scala,14,8,22 ,"Jul 7, 2023"
1707,core/src/test/scala/unit/kafka/server/ReplicaManagerTest.scala,3,2,5 ,"Jul 10, 2023"
1708,clients/src/main/java/org/apache/kafka/clients/consumer/internals/OffsetFetcher.java,13,72,85 ,"Jul 6, 2023"
1709,clients/src/main/java/org/apache/kafka/clients/consumer/internals/OffsetFetcherUtils.java,84,2,86 ,"Jul 6, 2023"
1710,clients/src/main/java/org/apache/kafka/clients/consumer/internals/SubscriptionState.java,1,1,2 ,"Jul 6, 2023"
1711,Jenkinsfile,5,61,66 ,"Jun 30, 2023"
1712,build.gradle,3,0,3 ,"Jun 30, 2023"
1713,clients/src/main/java/org/apache/kafka/common/utils/ChunkedBytesStream.java,8,6,14 ,"Jun 30, 2023"
1714,clients/src/test/java/org/apache/kafka/common/network/SslTransportLayerTest.java,3,0,3 ,"Jun 30, 2023"
1715,connect/mirror/src/test/java/org/apache/kafka/connect/mirror/OffsetSyncStoreTest.java,1,1,2 ,"Jun 30, 2023"
1716,core/src/test/scala/kafka/server/KafkaRequestHandlerTest.scala,1,1,2 ,"Jun 30, 2023"
1717,gradle/dependencies.gradle,22,6,28 ,"Jun 30, 2023"
1718,streams/src/test/java/org/apache/kafka/streams/state/internals/CachingInMemoryKeyValueStoreTest.java,1,1,2 ,"Jun 30, 2023"
1719,streams/src/test/java/org/apache/kafka/streams/state/internals/CachingPersistentWindowStoreTest.java,1,1,2 ,"Jun 30, 2023"
1720,streams/src/test/java/org/apache/kafka/streams/state/internals/TimeOrderedCachingPersistentWindowStoreTest.java,1,1,2 ,"Jun 30, 2023"
1721,streams/src/test/java/org/apache/kafka/streams/state/internals/TimeOrderedWindowStoreTest.java,1,1,2 ,"Jun 30, 2023"
1722,core/src/main/scala/kafka/log/LogCleaner.scala,1,0,1,"Jul 3, 2023"
1723,core/src/main/scala/kafka/log/LogCleanerManager.scala,32,6,38 ,"Jul 3, 2023"
1724,core/src/test/scala/unit/kafka/log/LogCleanerTest.scala,19,2,21 ,"Jul 3, 2023"
1725,connect/mirror-client/src/main/java/org/apache/kafka/connect/mirror/Checkpoint.java,1,1,2 ,"Jun 20, 2023"
1726,connect/mirror/src/test/java/org/apache/kafka/connect/mirror/MirrorMakerConfigTest.java,2,2,4 ,"Jun 20, 2023"
1727,connect/runtime/src/main/java/org/apache/kafka/connect/runtime/TopicCreationConfig.java,2,2,4 ,"Jun 20, 2023"
1728,connect/runtime/src/main/java/org/apache/kafka/connect/runtime/WorkerTransactionContext.java,4,4,8 ,"Jun 20, 2023"
1729,connect/runtime/src/test/java/org/apache/kafka/connect/integration/ErrorHandlingIntegrationTest.java,2,2,4 ,"Jun 20, 2023"
1730,connect/runtime/src/test/java/org/apache/kafka/connect/runtime/ErrorHandlingTaskTest.java,1,1,2 ,"Jun 20, 2023"
1731,connect/runtime/src/test/java/org/apache/kafka/connect/runtime/isolation/PluginDescTest.java,8,8,16 ,"Jun 20, 2023"
1732,connect/runtime/src/test/java/org/apache/kafka/connect/runtime/isolation/PluginUtilsTest.java,1,1,2 ,"Jun 20, 2023"
1733,connect/runtime/src/test/java/org/apache/kafka/connect/runtime/rest/ConnectRestServerTest.java,1,1,2 ,"Jun 20, 2023"
1734,connect/runtime/src/test/java/org/apache/kafka/connect/storage/KafkaConfigBackingStoreTest.java,3,3,6 ,"Jun 20, 2023"
1735,connect/runtime/src/test/java/org/apache/kafka/connect/util/clusters/EmbeddedKafkaCluster.java,1,1,2 ,"Jun 20, 2023"
1736,core/src/main/scala/kafka/admin/TopicCommand.scala,1,1,2 ,"Jun 20, 2023"
1737,core/src/main/scala/kafka/controller/ControllerChannelManager.scala,1,1,2 ,"Jun 20, 2023"
1738,core/src/main/scala/kafka/raft/RaftManager.scala,1,1,2 ,"Jun 20, 2023"
1739,core/src/main/scala/kafka/server/ForwardingManager.scala,1,1,2 ,"Jun 20, 2023"
1740,core/src/main/scala/kafka/server/KafkaConfig.scala,1,1,2 ,"Jun 20, 2023"
1741,core/src/main/scala/kafka/zk/KafkaZkClient.scala,2,2,4 ,"Jun 20, 2023"
1742,core/src/test/scala/integration/kafka/api/PlaintextConsumerTest.scala,2,2,4 ,"Jun 20, 2023"
1743,core/src/test/scala/integration/kafka/server/DynamicBrokerReconfigurationTest.scala,1,1,2 ,"Jun 20, 2023"
1744,core/src/test/scala/integration/kafka/server/RaftClusterSnapshotTest.scala,1,1,2 ,"Jun 20, 2023"
1745,core/src/test/scala/other/kafka/TestLinearWriteSpeed.scala,5,5,10 ,"Jun 20, 2023"
1746,core/src/test/scala/unit/kafka/admin/ConsumerGroupServiceTest.scala,3,3,6 ,"Jun 20, 2023"
1747,core/src/test/scala/unit/kafka/admin/ReassignPartitionsUnitTest.scala,9,9,18 ,"Jun 20, 2023"
1748,core/src/test/scala/unit/kafka/cluster/PartitionLockTest.scala,1,1,2 ,"Jun 20, 2023"
1749,core/src/test/scala/unit/kafka/coordinator/group/GroupCoordinatorTest.scala,3,3,6 ,"Jun 20, 2023"
1750,core/src/test/scala/unit/kafka/coordinator/group/GroupMetadataTest.scala,1,1,2 ,"Jun 20, 2023"
1751,core/src/test/scala/unit/kafka/coordinator/transaction/TransactionMarkerRequestCompletionHandlerTest.scala,1,1,2 ,"Jun 20, 2023"
1752,core/src/test/scala/unit/kafka/coordinator/transaction/TransactionStateManagerTest.scala,1,1,2 ,"Jun 20, 2023"
1753,core/src/test/scala/unit/kafka/integration/MinIsrConfigTest.scala,1,1,2 ,"Jun 20, 2023"
1754,core/src/test/scala/unit/kafka/log/OffsetMapTest.scala,2,2,4 ,"Jun 20, 2023"
1755,core/src/test/scala/unit/kafka/log/TimeIndexTest.scala,2,2,4 ,"Jun 20, 2023"
1756,core/src/test/scala/unit/kafka/security/authorizer/AuthorizerTest.scala,4,4,8 ,"Jun 20, 2023"
1757,core/src/test/scala/unit/kafka/server/AlterUserScramCredentialsRequestTest.scala,1,1,2 ,"Jun 20, 2023"
1758,core/src/test/scala/unit/kafka/server/CreateTopicsRequestWithPolicyTest.scala,2,2,4 ,"Jun 20, 2023"
1759,core/src/test/scala/unit/kafka/server/ZkAdminManagerTest.scala,1,1,2 ,"Jun 20, 2023"
1760,core/src/test/scala/unit/kafka/server/checkpoints/InMemoryLeaderEpochCheckpointTest.scala,2,2,4 ,"Jun 20, 2023"
1761,core/src/test/scala/unit/kafka/server/epoch/LeaderEpochFileCacheTest.scala,1,1,2 ,"Jun 20, 2023"
1762,clients/src/main/java/org/apache/kafka/common/requests/AddPartitionsToTxnRequest.java,15,4,19 ,"Jun 28, 2023"
1763,core/src/main/scala/kafka/network/RequestChannel.scala,12,9,21 ,"Jun 28, 2023"
1764,core/src/main/scala/kafka/server/AddPartitionsToTxnManager.scala,49,15,64 ,"Jun 28, 2023"
1765,core/src/test/scala/unit/kafka/server/AddPartitionsToTxnManagerTest.scala,77,2,79 ,"Jun 28, 2023"
1766,clients/src/main/java/org/apache/kafka/server/policy/CreateTopicPolicy.java,1,1,2 ,"Jun 24, 2023"
1767,clients/src/test/java/org/apache/kafka/clients/consumer/internals/ConsumerCoordinatorTest.java,19,3,22 ,"Jun 24, 2023"
1768,clients/src/main/java/org/apache/kafka/clients/admin/Admin.java,1,1,2 ,"Jun 28, 2023"
1769,clients/src/main/java/org/apache/kafka/clients/admin/ConfigEntry.java,1,1,2 ,"Jun 28, 2023"
1770,clients/src/main/java/org/apache/kafka/clients/admin/KafkaAdminClient.java,2,2,4 ,"Jun 28, 2023"
1771,clients/src/main/java/org/apache/kafka/clients/consumer/KafkaConsumer.java,1,1,2 ,"Jun 28, 2023"
1772,clients/src/main/java/org/apache/kafka/clients/consumer/NoOffsetForPartitionException.java,1,1,2 ,"Jun 28, 2023"
1773,clients/src/main/java/org/apache/kafka/clients/consumer/internals/AbstractStickyAssignor.java,2,2,4 ,"Jun 28, 2023"
1774,clients/src/main/java/org/apache/kafka/clients/consumer/internals/NetworkClientDelegate.java,1,1,2 ,"Jun 28, 2023"
1775,clients/src/main/java/org/apache/kafka/clients/consumer/internals/OffsetFetcher.java,1,1,2 ,"Jun 28, 2023"
1776,clients/src/main/java/org/apache/kafka/clients/consumer/internals/events/ApplicationEvent.java,1,1,2 ,"Jun 28, 2023"
1777,clients/src/main/java/org/apache/kafka/common/requests/FetchSnapshotResponse.java,1,1,2 ,"Jun 28, 2023"
1778,clients/src/main/java/org/apache/kafka/common/security/auth/SaslExtensions.java,1,1,2 ,"Jun 28, 2023"
1779,clients/src/main/java/org/apache/kafka/common/security/oauthbearer/internals/unsecured/OAuthBearerValidationUtils.java,1,1,2 ,"Jun 28, 2023"
1780,clients/src/main/java/org/apache/kafka/common/utils/ConfigUtils.java,1,1,2 ,"Jun 28, 2023"
1781,clients/src/main/resources/common/message/AlterPartitionResponse.json,1,1,2 ,"Jun 28, 2023"
1782,clients/src/main/resources/common/message/ConsumerGroupHeartbeatRequest.json,2,2,4 ,"Jun 28, 2023"
1783,clients/src/main/resources/common/message/CreateTopicsResponse.json,1,1,2 ,"Jun 28, 2023"
1784,clients/src/main/resources/common/message/FetchRequest.json,1,1,2 ,"Jun 28, 2023"
1785,clients/src/main/resources/common/message/ListOffsetsRequest.json,1,1,2 ,"Jun 28, 2023"
1786,clients/src/main/resources/common/message/ListOffsetsResponse.json,1,1,2 ,"Jun 28, 2023"
1787,clients/src/main/resources/common/message/MetadataRequest.json,1,1,2 ,"Jun 28, 2023"
1788,clients/src/main/resources/common/message/ProduceRequest.json,1,1,2 ,"Jun 28, 2023"
1789,clients/src/main/resources/common/message/TxnOffsetCommitRequest.json,1,1,2 ,"Jun 28, 2023"
1790,clients/src/test/java/org/apache/kafka/clients/NetworkClientTest.java,1,1,2 ,"Jun 28, 2023"
1791,clients/src/test/java/org/apache/kafka/clients/admin/DeleteConsumerGroupOffsetsResultTest.java,3,3,6 ,"Jun 28, 2023"
1792,clients/src/test/java/org/apache/kafka/clients/admin/internals/PartitionLeaderStrategyTest.java,1,1,2 ,"Jun 28, 2023"
1793,clients/src/test/java/org/apache/kafka/clients/consumer/KafkaConsumerTest.java,1,1,2 ,"Jun 28, 2023"
1794,clients/src/test/java/org/apache/kafka/clients/consumer/internals/ConsumerCoordinatorTest.java,1,1,2 ,"Jun 28, 2023"
1795,clients/src/test/java/org/apache/kafka/clients/consumer/internals/FetcherTest.java,2,2,4 ,"Jun 28, 2023"
1796,clients/src/test/java/org/apache/kafka/clients/producer/MockProducerTest.java,1,1,2 ,"Jun 28, 2023"
1797,clients/src/test/java/org/apache/kafka/common/feature/FeaturesTest.java,1,1,2 ,"Jun 28, 2023"
1798,docs/design.html,1,1,2 ,"Jun 21, 2023"
1799,docs/ops.html,7,7,14 ,"Jun 21, 2023"
1800,docs/security.html,3,3,6 ,"Jun 21, 2023"
1801,docs/streams/developer-guide/dsl-api.html,3,3,6 ,"Jun 21, 2023"
1802,docs/streams/developer-guide/dsl-topology-naming.html,1,1,2 ,"Jun 21, 2023"
1803,docs/streams/upgrade-guide.html,4,4,8 ,"Jun 21, 2023"
1804,checkstyle/suppressions.xml,1,1,2 ,"Jun 23, 2023"
1805,connect/api/src/main/java/org/apache/kafka/connect/sink/SinkConnector.java,8,1,9 ,"Jun 23, 2023"
1806,connect/api/src/main/java/org/apache/kafka/connect/source/SourceConnector.java,8,1,9 ,"Jun 23, 2023"
1807,connect/runtime/src/main/java/org/apache/kafka/connect/runtime/AbstractHerder.java,23,0,23 ,"Jun 23, 2023"
1808,connect/runtime/src/main/java/org/apache/kafka/connect/runtime/Herder.java,7,0,7 ,"Jun 23, 2023"
1809,clients/src/main/java/org/apache/kafka/common/utils/Utils.java,2,2,4 ,"Jun 28, 2023"
1810,metadata/src/main/java/org/apache/kafka/controller/ReplicationControlManager.java,3,3,6 ,"Jun 21, 2023"
1811,metadata/src/main/java/org/apache/kafka/metadata/migration/KRaftMigrationZkWriter.java,5,5,10 ,"Jun 21, 2023"
1812,metadata/src/test/java/org/apache/kafka/controller/FeatureControlManagerTest.java,1,1,2 ,"Jun 21, 2023"
1813,core/src/main/scala/kafka/server/KafkaConfig.scala,0,2,2 ,"Jun 22, 2023"
1814,core/src/test/scala/integration/kafka/zk/ZkMigrationIntegrationTest.scala,54,0,54 ,"Jun 22, 2023"
1815,core/src/test/scala/unit/kafka/server/KafkaConfigTest.scala,2,5,7 ,"Jun 22, 2023"
1816,metadata/src/main/java/org/apache/kafka/metadata/migration/KRaftMigrationDriver.java,2,2,4 ,"Jun 22, 2023"
1817,metadata/src/main/java/org/apache/kafka/metadata/migration/MigrationDriverState.java,1,1,2 ,"Jun 22, 2023"
1818,metadata/src/main/java/org/apache/kafka/controller/PartitionChangeBuilder.java,13,2,15 ,"Jun 21, 2023"
1819,metadata/src/main/java/org/apache/kafka/controller/ReplicationControlManager.java,7,2,9 ,"Jun 21, 2023"
1820,metadata/src/test/java/org/apache/kafka/controller/PartitionChangeBuilderTest.java,38,6,44 ,"Jun 21, 2023"
1821,streams/quickstart/java/src/main/resources/archetype-resources/src/main/java/WordCount.java,1,1,2 ,"Jun 20, 2023"
1822,streams/src/main/java/org/apache/kafka/streams/LagInfo.java,1,1,2 ,"Jun 20, 2023"
1823,streams/src/main/java/org/apache/kafka/streams/kstream/KStream.java,1,1,2 ,"Jun 20, 2023"
1824,streams/src/main/java/org/apache/kafka/streams/kstream/Produced.java,1,1,2 ,"Jun 20, 2023"
1825,streams/src/main/java/org/apache/kafka/streams/kstream/Repartitioned.java,1,1,2 ,"Jun 20, 2023"
1826,streams/src/main/java/org/apache/kafka/streams/kstream/internals/KStreamKStreamJoin.java,1,1,2 ,"Jun 20, 2023"
1827,streams/src/main/java/org/apache/kafka/streams/kstream/internals/graph/TableSourceNode.java,2,2,4 ,"Jun 20, 2023"
1828,streams/src/main/java/org/apache/kafka/streams/processor/internals/ForwardingDisabledProcessorContext.java,1,1,2 ,"Jun 20, 2023"
1829,streams/src/main/java/org/apache/kafka/streams/processor/internals/InternalTopologyBuilder.java,1,1,2 ,"Jun 20, 2023"
1830,streams/src/main/java/org/apache/kafka/streams/processor/internals/ProcessorRecordContext.java,1,1,2 ,"Jun 20, 2023"
1831,streams/src/main/java/org/apache/kafka/streams/state/Stores.java,1,1,2 ,"Jun 20, 2023"
1832,streams/src/main/java/org/apache/kafka/streams/state/internals/SessionKeySchema.java,1,1,2 ,"Jun 20, 2023"
1833,streams/src/test/java/org/apache/kafka/streams/StreamsConfigTest.java,5,5,10 ,"Jun 20, 2023"
1834,streams/src/test/java/org/apache/kafka/streams/integration/JoinStoreIntegrationTest.java,1,1,2 ,"Jun 20, 2023"
1835,streams/src/test/java/org/apache/kafka/streams/integration/KTableKTableForeignKeyJoinIntegrationTest.java,1,1,2 ,"Jun 20, 2023"
1836,streams/src/test/java/org/apache/kafka/streams/kstream/RepartitionTopicNamingTest.java,2,2,4 ,"Jun 20, 2023"
1837,streams/src/test/java/org/apache/kafka/streams/kstream/internals/TransformerSupplierAdapterTest.java,5,5,10 ,"Jun 20, 2023"
1838,streams/src/test/java/org/apache/kafka/streams/kstream/internals/graph/StreamsGraphTest.java,7,7,14 ,"Jun 20, 2023"
1839,streams/src/test/java/org/apache/kafka/streams/processor/internals/CopartitionedTopicsEnforcerTest.java,1,1,2 ,"Jun 20, 2023"
1840,streams/src/test/java/org/apache/kafka/streams/processor/internals/TaskManagerTest.java,1,1,2 ,"Jun 20, 2023"
1841,streams/src/test/java/org/apache/kafka/streams/processor/internals/TopicPartitionMetadataTest.java,1,1,2 ,"Jun 20, 2023"
1842,streams/src/test/java/org/apache/kafka/streams/state/internals/BufferValueTest.java,1,1,2 ,"Jun 20, 2023"
1843,streams/src/test/java/org/apache/kafka/streams/state/internals/CompositeReadOnlySessionStoreTest.java,1,1,2 ,"Jun 20, 2023"
1844,streams/src/test/java/org/apache/kafka/streams/state/internals/FilteredCacheIteratorTest.java,1,1,2 ,"Jun 20, 2023"
1845,streams/src/test/java/org/apache/kafka/streams/state/internals/SessionKeySchemaTest.java,1,1,2 ,"Jun 20, 2023"
1846,streams/src/test/java/org/apache/kafka/test/MockRestoreConsumer.java,1,1,2 ,"Jun 20, 2023"
1847,tools/src/test/java/org/apache/kafka/tools/ToolsTestUtils.java,0,1,1,"Jun 28, 2023"
1848,clients/src/main/java/org/apache/kafka/common/record/CompressionType.java,9,7,16 ,"Jun 22, 2023"
1849,clients/src/main/java/org/apache/kafka/common/record/DefaultRecord.java,1,1,2 ,"Jun 22, 2023"
1850,clients/src/main/java/org/apache/kafka/common/record/DefaultRecordBatch.java,1,1,2 ,"Jun 22, 2023"
1851,clients/src/main/java/org/apache/kafka/common/record/DefaultRecordsSend.java,1,1,2 ,"Jun 22, 2023"
1852,clients/src/main/java/org/apache/kafka/common/record/FileRecords.java,4,3,7 ,"Jun 22, 2023"
1853,clients/src/main/java/org/apache/kafka/common/record/LazyDownConversionRecordsSend.java,3,2,5 ,"Jun 22, 2023"
1854,clients/src/main/java/org/apache/kafka/common/record/LegacyRecord.java,2,2,4 ,"Jun 22, 2023"
1855,clients/src/main/java/org/apache/kafka/common/record/MemoryRecords.java,3,5,8 ,"Jun 22, 2023"
1856,clients/src/main/java/org/apache/kafka/common/record/MultiRecordsSend.java,1,1,2 ,"Jun 22, 2023"
1857,clients/src/main/java/org/apache/kafka/common/record/RecordsSend.java,4,4,8 ,"Jun 22, 2023"
1858,clients/src/main/java/org/apache/kafka/common/record/TransferableRecords.java,1,1,2 ,"Jun 22, 2023"
1859,clients/src/main/java/org/apache/kafka/common/record/UnalignedFileRecords.java,4,3,7 ,"Jun 22, 2023"
1860,clients/src/main/java/org/apache/kafka/common/record/UnalignedMemoryRecords.java,3,5,8 ,"Jun 22, 2023"
1861,clients/src/main/java/org/apache/kafka/common/serialization/ShortDeserializer.java,1,1,2 ,"Jun 22, 2023"
1862,clients/src/main/java/org/apache/kafka/common/utils/Utils.java,1,1,2 ,"Jun 22, 2023"
1863,clients/src/test/java/org/apache/kafka/common/compress/KafkaLZ4Test.java,1,1,2 ,"Jun 22, 2023"
1864,clients/src/test/java/org/apache/kafka/common/metrics/stats/MeterTest.java,1,1,2 ,"Jun 22, 2023"
1865,clients/src/test/java/org/apache/kafka/common/record/FileRecordsTest.java,5,5,10 ,"Jun 22, 2023"
1866,streams/src/main/java/org/apache/kafka/streams/processor/internals/TaskExecutor.java,1,1,2 ,"Jun 22, 2023"
1867,clients/src/main/java/org/apache/kafka/clients/admin/AdminClientConfig.java,2,1,3 ,"Jun 29, 2023"
1868,clients/src/main/java/org/apache/kafka/clients/consumer/ConsumerConfig.java,2,1,3 ,"Jun 29, 2023"
1869,clients/src/main/java/org/apache/kafka/clients/producer/ProducerConfig.java,2,1,3 ,"Jun 29, 2023"
1870,clients/src/test/java/org/apache/kafka/clients/consumer/ConsumerConfigTest.java,13,0,13 ,"Jun 29, 2023"
1871,clients/src/test/java/org/apache/kafka/clients/producer/ProducerConfigTest.java,13,0,13 ,"Jun 29, 2023"
1872,connect/mirror-client/src/main/java/org/apache/kafka/connect/mirror/MirrorClientConfig.java,1,1,2 ,"Jun 29, 2023"
1873,connect/mirror/src/main/java/org/apache/kafka/connect/mirror/MirrorConnectorConfig.java,1,1,2 ,"Jun 29, 2023"
1874,connect/mirror/src/main/java/org/apache/kafka/connect/mirror/MirrorMakerConfig.java,1,1,2 ,"Jun 29, 2023"
1875,connect/mirror/src/test/java/org/apache/kafka/connect/mirror/MirrorConnectorConfigTest.java,10,0,10 ,"Jun 29, 2023"
1876,connect/mirror/src/test/java/org/apache/kafka/connect/mirror/MirrorMakerConfigTest.java,10,0,10 ,"Jun 29, 2023"
1877,connect/runtime/src/main/java/org/apache/kafka/connect/runtime/distributed/DistributedConfig.java,2,2,4 ,"Jun 29, 2023"
1878,connect/runtime/src/test/java/org/apache/kafka/connect/runtime/distributed/DistributedConfigTest.java,12,0,12 ,"Jun 29, 2023"
1879,core/src/main/scala/kafka/admin/BrokerApiVersionsCommand.scala,1,1,2 ,"Jun 29, 2023"
1880,docs/security.html,1,1,2 ,"Jun 29, 2023"
1881,streams/src/main/java/org/apache/kafka/streams/StreamsConfig.java,1,1,2 ,"Jun 29, 2023"
1882,streams/src/test/java/org/apache/kafka/streams/StreamsConfigTest.java,9,0,9 ,"Jun 29, 2023"
1883,LICENSE-binary,1,0,1,"Jun 21, 2023"
1884,build.gradle,1,0,1,"Jun 21, 2023"
1885,core/src/main/scala/kafka/cluster/Partition.scala,7,3,10 ,"Jun 21, 2023"
1886,checkstyle/import-control.xml,3,0,3 ,"Jun 22, 2023"
1887,group-coordinator/src/main/java/org/apache/kafka/coordinator/group/GroupCoordinatorConfig.java,74,0,74 ,"Jun 22, 2023"
1888,tests/setup.py,1,1,2 ,"Jun 27, 2023"
1889,.github/workflows/stale.yml,1,1,2 ,"Jun 21, 2023"
1890,server-common/src/main/java/org/apache/kafka/server/common/MetadataVersion.java,1,1,2 ,"Jun 20, 2023"
1891,server-common/src/test/java/org/apache/kafka/queue/KafkaEventQueueTest.java,8,8,16 ,"Jun 20, 2023"
1892,server-common/src/test/java/org/apache/kafka/timeline/BaseHashTableTest.java,1,1,2 ,"Jun 20, 2023"
1893,connect/runtime/src/test/java/org/apache/kafka/connect/runtime/ErrorHandlingTaskTest.java,4,2,6 ,"Jun 23, 2023"
1894,docs/connect.html,47,2,49 ,"Jun 29, 2023"
1895,core/src/main/scala/kafka/coordinator/group/CoordinatorLoaderImpl.scala,170,0,170 ,"Jun 29, 2023"
1896,connect/runtime/src/main/java/org/apache/kafka/connect/util/ConnectUtils.java,1,1,2 ,"Jun 21, 2023"
1897,connect/runtime/src/test/java/org/apache/kafka/connect/util/ConnectUtilsTest.java,3,0,3 ,"Jun 21, 2023"
1898,core/src/main/scala/kafka/log/LogCleaner.scala,116,13,129 ,"Jun 21, 2023"
1899,core/src/main/scala/kafka/log/LogSegment.scala,0,1,1,"Jun 21, 2023"
1900,core/src/test/scala/integration/kafka/zk/ZkMigrationIntegrationTest.scala,1,2,3 ,"Jun 28, 2023"
1901,group-coordinator/src/main/java/org/apache/kafka/coordinator/group/generic/GenericGroup.java,4,4,8 ,"Jun 20, 2023"
1902,group-coordinator/src/test/java/org/apache/kafka/coordinator/group/GroupMetadataManagerTest.java,3,3,6 ,"Jun 20, 2023"
1903,group-coordinator/src/test/java/org/apache/kafka/coordinator/group/runtime/CoordinatorRuntimeTest.java,1,1,2 ,"Jun 20, 2023"
1904,streams/src/main/java/org/apache/kafka/streams/kstream/Joined.java,64,13,77 ,"Jun 29, 2023"
1905,streams/src/main/java/org/apache/kafka/streams/kstream/internals/KStreamGlobalKTableJoin.java,2,1,3 ,"Jun 29, 2023"
1906,streams/src/main/java/org/apache/kafka/streams/kstream/internals/KStreamImpl.java,21,1,22 ,"Jun 29, 2023"
1907,streams/src/main/java/org/apache/kafka/streams/kstream/internals/KStreamKTableJoin.java,13,2,15 ,"Jun 29, 2023"
1908,clients/src/test/java/org/apache/kafka/clients/producer/internals/SenderTest.java,23,1,24 ,"Jun 22, 2023"
1909,core/src/main/scala/kafka/coordinator/transaction/ProducerIdManager.scala,104,63,167 ,"Jun 22, 2023"
1910,core/src/main/scala/kafka/coordinator/transaction/TransactionCoordinator.scala,31,16,47 ,"Jun 22, 2023"
1911,core/src/main/scala/kafka/server/BrokerServer.scala,2,2,4 ,"Jun 22, 2023"
1912,connect/mirror/src/test/java/org/apache/kafka/connect/mirror/TestUtils.java,36,6,42 ,"Jun 21, 2023"
1913,connect/mirror/src/test/java/org/apache/kafka/connect/mirror/integration/MirrorConnectorsIntegrationBaseTest.java,67,47,114 ,"Jun 21, 2023"
1914,metadata/src/main/java/org/apache/kafka/controller/PartitionChangeBuilder.java,8,4,12 ,"Jun 27, 2023"
1915,metadata/src/main/java/org/apache/kafka/controller/ReplicationControlManager.java,6,6,12 ,"Jun 27, 2023"
1916,metadata/src/test/java/org/apache/kafka/controller/PartitionChangeBuilderTest.java,43,7,50 ,"Jun 27, 2023"
1917,server-common/src/main/java/org/apache/kafka/server/common/MetadataVersion.java,2,2,4 ,"Jun 27, 2023"
1918,TROGDOR.md,1,1,2 ,"Jun 21, 2023"
1919,streams/src/main/java/org/apache/kafka/streams/kstream/internals/KTableImpl.java,4,4,8 ,"Jun 10, 2023"
1920,streams/src/main/java/org/apache/kafka/streams/kstream/internals/suppress/KTableSuppressProcessorSupplier.java,3,3,6 ,"Jun 10, 2023"
1921,clients/src/main/java/org/apache/kafka/clients/consumer/internals/ConsumerCoordinator.java,36,3,39 ,"Jun 7, 2023"
1922,clients/src/test/java/org/apache/kafka/clients/consumer/internals/ConsumerCoordinatorTest.java,42,0,42 ,"Jun 7, 2023"
1923,core/src/test/scala/unit/kafka/zk/migration/ZkAclMigrationClientTest.scala,7,8,15 ,"Jun 7, 2023"
1924,connect/runtime/src/main/java/org/apache/kafka/connect/runtime/distributed/DistributedHerder.java,7,0,7 ,"Jun 5, 2023"
1925,connect/runtime/src/test/java/org/apache/kafka/connect/runtime/distributed/DistributedHerderTest.java,20,15,35 ,"Jun 5, 2023"
1926,core/src/main/scala/kafka/server/ControllerServer.scala,2,1,3 ,"Jun 2, 2023"
1927,core/src/main/scala/kafka/server/SharedServer.scala,13,3,16 ,"Jun 2, 2023"
1928,metadata/src/main/java/org/apache/kafka/controller/QuorumController.java,54,55,109 ,"Jun 2, 2023"
1929,metadata/src/main/java/org/apache/kafka/controller/ReplicationControlManager.java,5,3,8 ,"Jun 2, 2023"
1930,group-coordinator/src/main/java/org/apache/kafka/coordinator/group/runtime/CoordinatorLoader.java,42,0,42 ,"Jun 2, 2023"
1931,group-coordinator/src/main/java/org/apache/kafka/coordinator/group/runtime/CoordinatorPlayback.java,36,0,36 ,"Jun 2, 2023"
1932,.asf.yaml,6,0,6 ,"Jun 6, 2023"
1933,.asf.yaml,0,6,6 ,"Jun 6, 2023"
1934,core/src/test/scala/unit/kafka/server/ReplicaManagerConcurrencyTest.scala,8,10,18 ,"Jun 6, 2023"
1935,core/src/test/scala/unit/kafka/server/metadata/BrokerMetadataPublisherTest.scala,8,10,18 ,"Jun 6, 2023"
1936,core/src/test/scala/unit/kafka/zk/migration/ZkMigrationClientTest.scala,11,11,22 ,"Jun 6, 2023"
1937,metadata/src/main/java/org/apache/kafka/controller/ReplicationControlManager.java,22,13,35 ,"Jun 6, 2023"
1938,metadata/src/main/java/org/apache/kafka/metadata/PartitionRegistration.java,87,1,88 ,"Jun 6, 2023"
1939,docs/connect.html,1,0,1,"Jun 7, 2023"
1940,connect/runtime/src/test/java/org/apache/kafka/connect/runtime/WorkerConnectorTest.java,78,55,133 ,"Jun 8, 2023"
1941,core/src/main/scala/kafka/cluster/Partition.scala,15,9,24 ,"Jun 7, 2023"
1942,core/src/test/java/kafka/test/ClusterTestExtensionsTest.java,1,1,2 ,"Jun 7, 2023"
1943,core/src/test/java/kafka/test/annotation/ClusterTest.java,1,1,2 ,"Jun 7, 2023"
1944,core/src/test/scala/integration/kafka/api/BaseProducerSendTest.scala,55,2,57 ,"Jun 7, 2023"
1945,core/src/test/scala/unit/kafka/cluster/PartitionTest.scala,103,1,104 ,"Jun 7, 2023"
1946,metadata/src/main/java/org/apache/kafka/controller/PartitionChangeBuilder.java,27,15,42 ,"Jun 7, 2023"
1947,connect/runtime/src/main/java/org/apache/kafka/connect/util/KafkaBasedLog.java,1,1,2 ,"Jun 5, 2023"
1948,core/src/main/scala/kafka/controller/KafkaController.scala,52,15,67 ,"Jun 6, 2023"
1949,core/src/test/scala/unit/kafka/controller/KafkaControllerTest.scala,74,0,74 ,"Jun 6, 2023"
1950,core/src/main/java/kafka/server/builders/LogManagerBuilder.java,8,1,9 ,"Jun 5, 2023"
1951,core/src/main/scala/kafka/cluster/Partition.scala,4,2,6 ,"Jun 5, 2023"
1952,core/src/main/scala/kafka/log/LogManager.scala,8,4,12 ,"Jun 5, 2023"
1953,core/src/main/scala/kafka/log/UnifiedLog.scala,2,5,7 ,"Jun 5, 2023"
1954,core/src/main/scala/kafka/server/ReplicaManager.scala,1,1,2 ,"Jun 5, 2023"
1955,core/src/test/scala/unit/kafka/log/LogLoaderTest.scala,2,1,3 ,"Jun 5, 2023"
1956,core/src/test/scala/unit/kafka/log/LogTestUtils.scala,0,1,1,"Jun 5, 2023"
1957,core/src/test/scala/unit/kafka/log/UnifiedLogTest.scala,7,7,14 ,"Jun 5, 2023"
1958,core/src/test/scala/unit/kafka/utils/TestUtils.scala,2,1,3 ,"Jun 5, 2023"
1959,storage/src/main/java/org/apache/kafka/server/log/remote/metadata/storage/ConsumerTask.java,1,1,2 ,"Jun 5, 2023"
1960,core/src/main/scala/kafka/raft/KafkaMetadataLog.scala,2,20,22 ,"Jun 6, 2023"
1961,core/src/main/scala/kafka/raft/RaftManager.scala,0,1,1,"Jun 6, 2023"
1962,core/src/test/scala/kafka/raft/KafkaMetadataLogTest.scala,0,1,1,"Jun 6, 2023"
1963,core/src/test/scala/unit/kafka/tools/DumpLogSegmentsTest.scala,0,1,1,"Jun 6, 2023"
1964,raft/src/main/java/org/apache/kafka/raft/internals/IdentitySerde.java,43,0,43 ,"Jun 6, 2023"
1965,raft/src/main/java/org/apache/kafka/snapshot/Snapshots.java,24,0,24 ,"Jun 6, 2023"
1966,raft/src/test/java/org/apache/kafka/snapshot/SnapshotWriterReaderTest.java,2,3,5 ,"Jun 6, 2023"
1967,clients/src/main/java/org/apache/kafka/common/security/oauthbearer/internals/secured/FileTokenRetriever.java,2,0,2 ,"Jun 11, 2023"
1968,clients/src/test/java/org/apache/kafka/common/security/oauthbearer/OAuthBearerLoginCallbackHandlerTest.java,29,0,29 ,"Jun 11, 2023"
1969,build.gradle,1,0,1,"Jun 9, 2023"
1970,checkstyle/import-control.xml,1,0,1,"Jun 9, 2023"
1971,core/src/test/scala/kafka/common/InterBrokerSendThreadTest.scala,1,1,2 ,"Jun 9, 2023"
1972,core/src/test/scala/kafka/metrics/LinuxIoMetricsCollectorTest.scala,2,1,3 ,"Jun 9, 2023"
1973,core/src/test/scala/kafka/raft/KafkaMetadataLogTest.scala,2,1,3 ,"Jun 9, 2023"
1974,core/src/test/scala/kafka/server/LocalLeaderEndPointTest.scala,2,2,4 ,"Jun 9, 2023"
1975,core/src/test/scala/kafka/server/RemoteLeaderEndPointTest.scala,2,1,3 ,"Jun 9, 2023"
1976,core/src/test/scala/other/kafka/StressTestLog.scala,1,0,1,"Jun 9, 2023"
1977,core/src/test/scala/unit/kafka/cluster/AbstractPartitionTest.scala,2,1,3 ,"Jun 9, 2023"
1978,core/src/test/scala/unit/kafka/cluster/PartitionLockTest.scala,1,0,1,"Jun 9, 2023"
1979,core/src/test/scala/unit/kafka/cluster/PartitionTest.scala,1,1,2 ,"Jun 9, 2023"
1980,core/src/test/scala/unit/kafka/cluster/ReplicaTest.scala,1,1,2 ,"Jun 9, 2023"
1981,core/src/test/scala/unit/kafka/controller/KafkaControllerTest.scala,2,1,3 ,"Jun 9, 2023"
1982,core/src/test/scala/unit/kafka/coordinator/AbstractCoordinatorConcurrencyTest.scala,1,1,2 ,"Jun 9, 2023"
1983,core/src/test/scala/unit/kafka/coordinator/group/GroupCoordinatorAdapterTest.scala,1,1,2 ,"Jun 9, 2023"
1984,core/src/test/scala/unit/kafka/coordinator/group/GroupCoordinatorTest.scala,1,1,2 ,"Jun 9, 2023"
1985,core/src/test/scala/unit/kafka/coordinator/group/GroupMetadataManagerTest.scala,2,2,4 ,"Jun 9, 2023"
1986,core/src/test/scala/unit/kafka/coordinator/transaction/TransactionMetadataTest.scala,1,1,2 ,"Jun 9, 2023"
1987,core/src/test/scala/unit/kafka/log/AbstractLogCleanerIntegrationTest.scala,2,1,3 ,"Jun 9, 2023"
1988,core/src/test/scala/unit/kafka/log/BrokerCompressionTest.scala,1,0,1,"Jun 9, 2023"
1989,core/src/test/scala/unit/kafka/log/LocalLogTest.scala,2,2,4 ,"Jun 9, 2023"
1990,core/src/test/scala/unit/kafka/log/LogCleanerIntegrationTest.scala,2,2,4 ,"Jun 9, 2023"
1991,core/src/test/scala/unit/kafka/log/LogCleanerLagIntegrationTest.scala,1,0,1,"Jun 9, 2023"
1992,core/src/test/scala/unit/kafka/log/LogCleanerManagerTest.scala,1,0,1,"Jun 9, 2023"
1993,core/src/test/scala/unit/kafka/log/LogCleanerParameterizedIntegrationTest.scala,1,0,1,"Jun 9, 2023"
1994,core/src/test/scala/unit/kafka/log/LogCleanerTest.scala,1,0,1,"Jun 9, 2023"
1995,core/src/test/scala/unit/kafka/log/LogLoaderTest.scala,2,2,4 ,"Jun 9, 2023"
1996,core/src/test/scala/unit/kafka/log/LogManagerTest.scala,1,0,1,"Jun 9, 2023"
1997,core/src/test/scala/unit/kafka/log/LogValidatorTest.scala,1,1,2 ,"Jun 9, 2023"
1998,clients/src/main/resources/common/message/FetchRequest.json,1,1,2 ,"Jun 5, 2023"
1999,.github/workflows/stale.yml,9,6,15 ,"Jun 10, 2023"
2000,metadata/src/test/java/org/apache/kafka/controller/QuorumControllerTest.java,21,15,36 ,"Jun 4, 2023"
2001,clients/src/test/java/org/apache/kafka/test/Microbenchmarks.java,1,1,2 ,"Jun 6, 2023"
2002,core/src/test/scala/integration/kafka/api/PlaintextAdminIntegrationTest.scala,1,1,2 ,"Jun 6, 2023"
2003,raft/src/test/java/org/apache/kafka/raft/MockLog.java,1,5,6 ,"Jun 6, 2023"
2004,connect/runtime/src/main/java/org/apache/kafka/connect/runtime/TransformationChain.java,1,0,1,"Jun 5, 2023"
2005,clients/src/main/java/org/apache/kafka/clients/producer/internals/TransactionManager.java,11,9,20 ,"Jun 7, 2023"
2006,clients/src/main/java/org/apache/kafka/common/requests/TxnOffsetCommitResponse.java,1,0,1,"Jun 7, 2023"
2007,clients/src/test/java/org/apache/kafka/clients/producer/internals/TransactionManagerTest.java,44,3,47 ,"Jun 7, 2023"
2008,clients/src/main/java/org/apache/kafka/common/requests/ProduceResponse.java,18,1,19 ,"Jun 6, 2023"
2009,core/src/main/scala/kafka/coordinator/group/CoordinatorPartitionWriter.scala,175,0,175 ,"Jun 6, 2023"
2010,core/src/main/scala/kafka/server/ActionQueue.scala,16,6,22 ,"Jun 6, 2023"
2011,core/src/main/scala/kafka/server/ReplicaManager.scala,19,19,38 ,"Jun 6, 2023"
2012,core/src/test/scala/unit/kafka/coordinator/AbstractCoordinatorConcurrencyTest.scala,2,1,3 ,"Jun 6, 2023"
2013,connect/runtime/src/main/java/org/apache/kafka/connect/runtime/isolation/DelegatingClassLoader.java,40,144,184 ,"Jun 6, 2023"
2014,connect/runtime/src/main/java/org/apache/kafka/connect/runtime/isolation/PluginDesc.java,10,1,11 ,"Jun 6, 2023"
2015,connect/runtime/src/main/java/org/apache/kafka/connect/runtime/distributed/DistributedHerder.java,3,1,4 ,"Jun 5, 2023"
2016,release.py,3,1,4 ,"Jun 5, 2023"
2017,streams/src/main/java/org/apache/kafka/streams/processor/internals/StreamsMetadataState.java,14,9,23 ,"Jun 7, 2023"
2018,streams/src/main/java/org/apache/kafka/streams/processor/internals/StreamsPartitionAssignor.java,1,2,3 ,"Jun 7, 2023"
2019,streams/src/test/java/org/apache/kafka/streams/processor/internals/StreamsMetadataStateTest.java,18,23,41 ,"Jun 7, 2023"
2020,streams/src/test/java/org/apache/kafka/streams/processor/internals/StreamsPartitionAssignorTest.java,7,4,11 ,"Jun 7, 2023"
2021,checkstyle/suppressions.xml,1,1,2 ,"Jun 8, 2023"
2022,clients/src/main/java/org/apache/kafka/common/compress/ZstdFactory.java,8,8,16 ,"Jun 5, 2023"
2023,clients/src/main/java/org/apache/kafka/common/record/CompressionType.java,59,11,70 ,"Jun 5, 2023"
2024,.github/workflows/stale.yml,52,0,52 ,"Jun 10, 2023"
2025,connect/runtime/src/test/java/org/apache/kafka/connect/runtime/isolation/TestPlugins.java,1,1,2 ,"Jun 3, 2023"
2026,connect/runtime/src/test/java/org/apache/kafka/connect/runtime/rest/resources/ConnectorPluginsResourceTest.java,1,1,2 ,"Jun 3, 2023"
2027,core/src/main/scala/kafka/server/ReplicaManager.scala,8,4,12 ,"Jun 9, 2023"
2028,.github/workflows/stale.yml,1,1,2 ,"Jun 10, 2023"
2029,streams/src/main/java/org/apache/kafka/streams/kstream/internals/KTableImpl.java,4,4,8 ,"Jun 10, 2023"
2030,streams/src/main/java/org/apache/kafka/streams/kstream/internals/suppress/KTableSuppressProcessorSupplier.java,3,3,6 ,"Jun 10, 2023"
2031,clients/src/main/java/org/apache/kafka/clients/consumer/internals/ConsumerCoordinator.java,36,3,39 ,"Jun 7, 2023"
2032,clients/src/test/java/org/apache/kafka/clients/consumer/internals/ConsumerCoordinatorTest.java,42,0,42 ,"Jun 7, 2023"
2033,core/src/test/scala/unit/kafka/zk/migration/ZkAclMigrationClientTest.scala,7,8,15 ,"Jun 7, 2023"
2034,connect/runtime/src/main/java/org/apache/kafka/connect/runtime/distributed/DistributedHerder.java,7,0,7 ,"Jun 5, 2023"
2035,connect/runtime/src/test/java/org/apache/kafka/connect/runtime/distributed/DistributedHerderTest.java,20,15,35 ,"Jun 5, 2023"
2036,core/src/main/scala/kafka/server/ControllerServer.scala,2,1,3 ,"Jun 2, 2023"
2037,core/src/main/scala/kafka/server/SharedServer.scala,13,3,16 ,"Jun 2, 2023"
2038,metadata/src/main/java/org/apache/kafka/controller/QuorumController.java,54,55,109 ,"Jun 2, 2023"
2039,metadata/src/main/java/org/apache/kafka/controller/ReplicationControlManager.java,5,3,8 ,"Jun 2, 2023"
2040,group-coordinator/src/main/java/org/apache/kafka/coordinator/group/runtime/CoordinatorLoader.java,42,0,42 ,"Jun 2, 2023"
2041,group-coordinator/src/main/java/org/apache/kafka/coordinator/group/runtime/CoordinatorPlayback.java,36,0,36 ,"Jun 2, 2023"
2042,.asf.yaml,6,0,6 ,"Jun 6, 2023"
2043,.asf.yaml,0,6,6 ,"Jun 6, 2023"
2044,core/src/test/scala/unit/kafka/server/ReplicaManagerConcurrencyTest.scala,8,10,18 ,"Jun 6, 2023"
2045,core/src/test/scala/unit/kafka/server/metadata/BrokerMetadataPublisherTest.scala,8,10,18 ,"Jun 6, 2023"
2046,core/src/test/scala/unit/kafka/zk/migration/ZkMigrationClientTest.scala,11,11,22 ,"Jun 6, 2023"
2047,metadata/src/main/java/org/apache/kafka/controller/ReplicationControlManager.java,22,13,35 ,"Jun 6, 2023"
2048,metadata/src/main/java/org/apache/kafka/metadata/PartitionRegistration.java,87,1,88 ,"Jun 6, 2023"
2049,docs/connect.html,1,0,1,"Jun 7, 2023"
2050,connect/runtime/src/test/java/org/apache/kafka/connect/runtime/WorkerConnectorTest.java,78,55,133 ,"Jun 8, 2023"
2051,core/src/main/scala/kafka/cluster/Partition.scala,15,9,24 ,"Jun 7, 2023"
2052,core/src/test/java/kafka/test/ClusterTestExtensionsTest.java,1,1,2 ,"Jun 7, 2023"
2053,core/src/test/java/kafka/test/annotation/ClusterTest.java,1,1,2 ,"Jun 7, 2023"
2054,core/src/test/scala/integration/kafka/api/BaseProducerSendTest.scala,55,2,57 ,"Jun 7, 2023"
2055,core/src/test/scala/unit/kafka/cluster/PartitionTest.scala,103,1,104 ,"Jun 7, 2023"
2056,metadata/src/main/java/org/apache/kafka/controller/PartitionChangeBuilder.java,27,15,42 ,"Jun 7, 2023"
2057,connect/runtime/src/main/java/org/apache/kafka/connect/util/KafkaBasedLog.java,1,1,2 ,"Jun 5, 2023"
2058,core/src/main/scala/kafka/controller/KafkaController.scala,52,15,67 ,"Jun 6, 2023"
2059,core/src/test/scala/unit/kafka/controller/KafkaControllerTest.scala,74,0,74 ,"Jun 6, 2023"
2060,core/src/main/java/kafka/server/builders/LogManagerBuilder.java,8,1,9 ,"Jun 5, 2023"
2061,core/src/main/scala/kafka/cluster/Partition.scala,4,2,6 ,"Jun 5, 2023"
2062,core/src/main/scala/kafka/log/LogManager.scala,8,4,12 ,"Jun 5, 2023"
2063,core/src/main/scala/kafka/log/UnifiedLog.scala,2,5,7 ,"Jun 5, 2023"
2064,core/src/main/scala/kafka/server/ReplicaManager.scala,1,1,2 ,"Jun 5, 2023"
2065,core/src/test/scala/unit/kafka/log/LogLoaderTest.scala,2,1,3 ,"Jun 5, 2023"
2066,core/src/test/scala/unit/kafka/log/LogTestUtils.scala,0,1,1,"Jun 5, 2023"
2067,core/src/test/scala/unit/kafka/log/UnifiedLogTest.scala,7,7,14 ,"Jun 5, 2023"
2068,core/src/test/scala/unit/kafka/utils/TestUtils.scala,2,1,3 ,"Jun 5, 2023"
2069,storage/src/main/java/org/apache/kafka/server/log/remote/metadata/storage/ConsumerTask.java,1,1,2 ,"Jun 5, 2023"
2070,core/src/main/scala/kafka/raft/KafkaMetadataLog.scala,2,20,22 ,"Jun 6, 2023"
2071,core/src/main/scala/kafka/raft/RaftManager.scala,0,1,1,"Jun 6, 2023"
2072,core/src/test/scala/kafka/raft/KafkaMetadataLogTest.scala,0,1,1,"Jun 6, 2023"
2073,core/src/test/scala/unit/kafka/tools/DumpLogSegmentsTest.scala,0,1,1,"Jun 6, 2023"
2074,raft/src/main/java/org/apache/kafka/raft/internals/IdentitySerde.java,43,0,43 ,"Jun 6, 2023"
2075,raft/src/main/java/org/apache/kafka/snapshot/Snapshots.java,24,0,24 ,"Jun 6, 2023"
2076,raft/src/test/java/org/apache/kafka/snapshot/SnapshotWriterReaderTest.java,2,3,5 ,"Jun 6, 2023"
2077,clients/src/main/java/org/apache/kafka/common/security/oauthbearer/internals/secured/FileTokenRetriever.java,2,0,2 ,"Jun 11, 2023"
2078,clients/src/test/java/org/apache/kafka/common/security/oauthbearer/OAuthBearerLoginCallbackHandlerTest.java,29,0,29 ,"Jun 11, 2023"
2079,build.gradle,1,0,1,"Jun 9, 2023"
2080,checkstyle/import-control.xml,1,0,1,"Jun 9, 2023"
2081,core/src/test/scala/kafka/common/InterBrokerSendThreadTest.scala,1,1,2 ,"Jun 9, 2023"
2082,core/src/test/scala/kafka/metrics/LinuxIoMetricsCollectorTest.scala,2,1,3 ,"Jun 9, 2023"
2083,core/src/test/scala/kafka/raft/KafkaMetadataLogTest.scala,2,1,3 ,"Jun 9, 2023"
2084,core/src/test/scala/kafka/server/LocalLeaderEndPointTest.scala,2,2,4 ,"Jun 9, 2023"
2085,core/src/test/scala/kafka/server/RemoteLeaderEndPointTest.scala,2,1,3 ,"Jun 9, 2023"
2086,core/src/test/scala/other/kafka/StressTestLog.scala,1,0,1,"Jun 9, 2023"
2087,core/src/test/scala/unit/kafka/cluster/AbstractPartitionTest.scala,2,1,3 ,"Jun 9, 2023"
2088,core/src/test/scala/unit/kafka/cluster/PartitionLockTest.scala,1,0,1,"Jun 9, 2023"
2089,core/src/test/scala/unit/kafka/cluster/PartitionTest.scala,1,1,2 ,"Jun 9, 2023"
2090,core/src/test/scala/unit/kafka/cluster/ReplicaTest.scala,1,1,2 ,"Jun 9, 2023"
2091,core/src/test/scala/unit/kafka/controller/KafkaControllerTest.scala,2,1,3 ,"Jun 9, 2023"
2092,core/src/test/scala/unit/kafka/coordinator/AbstractCoordinatorConcurrencyTest.scala,1,1,2 ,"Jun 9, 2023"
2093,core/src/test/scala/unit/kafka/coordinator/group/GroupCoordinatorAdapterTest.scala,1,1,2 ,"Jun 9, 2023"
2094,core/src/test/scala/unit/kafka/coordinator/group/GroupCoordinatorTest.scala,1,1,2 ,"Jun 9, 2023"
2095,core/src/test/scala/unit/kafka/coordinator/group/GroupMetadataManagerTest.scala,2,2,4 ,"Jun 9, 2023"
2096,core/src/test/scala/unit/kafka/coordinator/transaction/TransactionMetadataTest.scala,1,1,2 ,"Jun 9, 2023"
2097,core/src/test/scala/unit/kafka/log/AbstractLogCleanerIntegrationTest.scala,2,1,3 ,"Jun 9, 2023"
2098,core/src/test/scala/unit/kafka/log/BrokerCompressionTest.scala,1,0,1,"Jun 9, 2023"
2099,core/src/test/scala/unit/kafka/log/LocalLogTest.scala,2,2,4 ,"Jun 9, 2023"
2100,core/src/test/scala/unit/kafka/log/LogCleanerIntegrationTest.scala,2,2,4 ,"Jun 9, 2023"
2101,core/src/test/scala/unit/kafka/log/LogCleanerLagIntegrationTest.scala,1,0,1,"Jun 9, 2023"
2102,core/src/test/scala/unit/kafka/log/LogCleanerManagerTest.scala,1,0,1,"Jun 9, 2023"
2103,core/src/test/scala/unit/kafka/log/LogCleanerParameterizedIntegrationTest.scala,1,0,1,"Jun 9, 2023"
2104,core/src/test/scala/unit/kafka/log/LogCleanerTest.scala,1,0,1,"Jun 9, 2023"
2105,core/src/test/scala/unit/kafka/log/LogLoaderTest.scala,2,2,4 ,"Jun 9, 2023"
2106,core/src/test/scala/unit/kafka/log/LogManagerTest.scala,1,0,1,"Jun 9, 2023"
2107,core/src/test/scala/unit/kafka/log/LogValidatorTest.scala,1,1,2 ,"Jun 9, 2023"
2108,clients/src/main/resources/common/message/FetchRequest.json,1,1,2 ,"Jun 5, 2023"
2109,.github/workflows/stale.yml,9,6,15 ,"Jun 10, 2023"
2110,metadata/src/test/java/org/apache/kafka/controller/QuorumControllerTest.java,21,15,36 ,"Jun 4, 2023"
2111,clients/src/test/java/org/apache/kafka/test/Microbenchmarks.java,1,1,2 ,"Jun 6, 2023"
2112,core/src/test/scala/integration/kafka/api/PlaintextAdminIntegrationTest.scala,1,1,2 ,"Jun 6, 2023"
2113,raft/src/test/java/org/apache/kafka/raft/MockLog.java,1,5,6 ,"Jun 6, 2023"
2114,connect/runtime/src/main/java/org/apache/kafka/connect/runtime/TransformationChain.java,1,0,1,"Jun 5, 2023"
2115,clients/src/main/java/org/apache/kafka/clients/producer/internals/TransactionManager.java,11,9,20 ,"Jun 7, 2023"
2116,clients/src/main/java/org/apache/kafka/common/requests/TxnOffsetCommitResponse.java,1,0,1,"Jun 7, 2023"
2117,clients/src/test/java/org/apache/kafka/clients/producer/internals/TransactionManagerTest.java,44,3,47 ,"Jun 7, 2023"
2118,clients/src/main/java/org/apache/kafka/common/requests/ProduceResponse.java,18,1,19 ,"Jun 6, 2023"
2119,core/src/main/scala/kafka/coordinator/group/CoordinatorPartitionWriter.scala,175,0,175 ,"Jun 6, 2023"
2120,core/src/main/scala/kafka/server/ActionQueue.scala,16,6,22 ,"Jun 6, 2023"
2121,core/src/main/scala/kafka/server/ReplicaManager.scala,19,19,38 ,"Jun 6, 2023"
2122,core/src/test/scala/unit/kafka/coordinator/AbstractCoordinatorConcurrencyTest.scala,2,1,3 ,"Jun 6, 2023"
2123,connect/runtime/src/main/java/org/apache/kafka/connect/runtime/isolation/DelegatingClassLoader.java,40,144,184 ,"Jun 6, 2023"
2124,connect/runtime/src/main/java/org/apache/kafka/connect/runtime/isolation/PluginDesc.java,10,1,11 ,"Jun 6, 2023"
2125,connect/runtime/src/main/java/org/apache/kafka/connect/runtime/distributed/DistributedHerder.java,3,1,4 ,"Jun 5, 2023"
2126,release.py,3,1,4 ,"Jun 5, 2023"
2127,streams/src/main/java/org/apache/kafka/streams/processor/internals/StreamsMetadataState.java,14,9,23 ,"Jun 7, 2023"
2128,streams/src/main/java/org/apache/kafka/streams/processor/internals/StreamsPartitionAssignor.java,1,2,3 ,"Jun 7, 2023"
2129,streams/src/test/java/org/apache/kafka/streams/processor/internals/StreamsMetadataStateTest.java,18,23,41 ,"Jun 7, 2023"
2130,streams/src/test/java/org/apache/kafka/streams/processor/internals/StreamsPartitionAssignorTest.java,7,4,11 ,"Jun 7, 2023"
2131,checkstyle/suppressions.xml,1,1,2 ,"Jun 8, 2023"
2132,clients/src/main/java/org/apache/kafka/common/compress/ZstdFactory.java,8,8,16 ,"Jun 5, 2023"
2133,clients/src/main/java/org/apache/kafka/common/record/CompressionType.java,59,11,70 ,"Jun 5, 2023"
2134,.github/workflows/stale.yml,52,0,52 ,"Jun 10, 2023"
2135,connect/runtime/src/test/java/org/apache/kafka/connect/runtime/isolation/TestPlugins.java,1,1,2 ,"Jun 3, 2023"
2136,connect/runtime/src/test/java/org/apache/kafka/connect/runtime/rest/resources/ConnectorPluginsResourceTest.java,1,1,2 ,"Jun 3, 2023"
2137,core/src/main/scala/kafka/server/ReplicaManager.scala,8,4,12 ,"Jun 9, 2023"
2138,.github/workflows/stale.yml,1,1,2 ,"Jun 10, 2023"
2139,core/src/test/scala/unit/kafka/zk/migration/ZkConfigMigrationClientTest.scala,72,6,78 ,"May 31, 2023"
2140,metadata/src/main/java/org/apache/kafka/metadata/migration/KRaftMigrationZkWriter.java,24,2,26 ,"May 31, 2023"
2141,gradle/dependencies.gradle,1,1,2 ,"May 31, 2023"
2142,checkstyle/import-control.xml,3,0,3 ,"May 31, 2023"
2143,checkstyle/suppressions.xml,5,1,6 ,"May 31, 2023"
2144,build.gradle,2,0,2 ,"Jun 1, 2023"
2145,checkstyle/import-control-jmh-benchmarks.xml,1,0,1,"Jun 1, 2023"
2146,connect/transforms/src/main/java/org/apache/kafka/connect/transforms/ReplaceField.java,6,4,10 ,"Jun 1, 2023"
2147,jmh-benchmarks/src/main/java/org/apache/kafka/jmh/connect/ReplaceFieldBenchmark.java,81,0,81 ,"Jun 1, 2023"
2148,metadata/src/main/java/org/apache/kafka/controller/PartitionChangeBuilder.java,11,8,19 ,"May 31, 2023"
2149,core/src/test/scala/unit/kafka/log/LogSegmentTest.scala,28,0,28 ,"Jun 1, 2023"
2150,connect/runtime/src/main/java/org/apache/kafka/connect/runtime/ExactlyOnceWorkerSourceTask.java,9,9,18 ,"May 31, 2023"
2151,core/src/main/scala/kafka/server/AddPartitionsToTxnManager.scala,64,58,122 ,"Jun 1, 2023"
2152,core/src/test/scala/unit/kafka/server/AddPartitionsToTxnManagerTest.scala,14,8,22 ,"Jun 1, 2023"
2153,docs/upgrade.html,61,2,63 ,"Jun 1, 2023"
2154,core/src/main/java/kafka/server/builders/LogManagerBuilder.java,3,3,6 ,"May 30, 2023"
2155,core/src/main/scala/kafka/log/LogManager.scala,1,1,2 ,"May 30, 2023"
2156,core/src/main/scala/kafka/raft/KafkaMetadataLog.scala,1,1,2 ,"May 30, 2023"
2157,core/src/test/scala/other/kafka/StressTestLog.scala,1,1,2 ,"May 30, 2023"
2158,core/src/test/scala/other/kafka/TestLinearWriteSpeed.scala,1,1,2 ,"May 30, 2023"
2159,core/src/test/scala/unit/kafka/cluster/PartitionLockTest.scala,1,1,2 ,"May 30, 2023"
2160,core/src/test/scala/unit/kafka/cluster/PartitionTest.scala,1,1,2 ,"May 30, 2023"
2161,core/src/test/scala/unit/kafka/log/AbstractLogCleanerIntegrationTest.scala,1,1,2 ,"May 30, 2023"
2162,core/src/test/scala/unit/kafka/log/BrokerCompressionTest.scala,1,1,2 ,"May 30, 2023"
2163,core/src/test/scala/unit/kafka/log/LogCleanerManagerTest.scala,1,1,2 ,"May 30, 2023"
2164,core/src/test/scala/unit/kafka/log/LogCleanerTest.scala,1,1,2 ,"May 30, 2023"
2165,core/src/test/scala/unit/kafka/log/LogConcurrencyTest.scala,1,1,2 ,"May 30, 2023"
2166,core/src/test/scala/unit/kafka/log/LogLoaderTest.scala,6,6,12 ,"May 30, 2023"
2167,core/src/test/scala/unit/kafka/log/LogManagerTest.scala,2,2,4 ,"May 30, 2023"
2168,core/src/test/scala/unit/kafka/log/LogSegmentTest.scala,1,1,2 ,"May 30, 2023"
2169,core/src/test/scala/unit/kafka/log/LogTestUtils.scala,1,1,2 ,"May 30, 2023"
2170,core/src/test/scala/unit/kafka/log/ProducerStateManagerTest.scala,1,1,2 ,"May 30, 2023"
2171,core/src/test/scala/unit/kafka/log/UnifiedLogTest.scala,3,3,6 ,"May 30, 2023"
2172,core/src/test/scala/unit/kafka/server/ReplicaManagerTest.scala,1,1,2 ,"May 30, 2023"
2173,core/src/test/scala/unit/kafka/tools/DumpLogSegmentsTest.scala,1,1,2 ,"May 30, 2023"
2174,core/src/test/scala/unit/kafka/utils/SchedulerTest.scala,1,1,2 ,"May 30, 2023"
2175,core/src/test/scala/unit/kafka/utils/TestUtils.scala,1,1,2 ,"May 30, 2023"
2176,jmh-benchmarks/src/main/java/org/apache/kafka/jmh/fetcher/ReplicaFetcherThreadBenchmark.java,1,1,2 ,"May 30, 2023"
2177,jmh-benchmarks/src/main/java/org/apache/kafka/jmh/partition/PartitionMakeFollowerBenchmark.java,1,1,2 ,"May 30, 2023"
2178,jmh-benchmarks/src/main/java/org/apache/kafka/jmh/partition/UpdateFollowerFetchStateBenchmark.java,1,1,2 ,"May 30, 2023"
2179,jmh-benchmarks/src/main/java/org/apache/kafka/jmh/server/PartitionCreationBench.java,1,1,2 ,"May 30, 2023"
2180,core/src/main/java/kafka/log/remote/RemoteLogManager.java,7,8,15 ,"May 31, 2023"
2181,tools/src/main/java/org/apache/kafka/tools/MetadataQuorumCommand.java,53,17,70 ,"May 29, 2023"
2182,tools/src/test/java/org/apache/kafka/tools/MetadataQuorumCommandErrorTest.java,16,0,16 ,"May 29, 2023"
2183,tools/src/test/java/org/apache/kafka/tools/MetadataQuorumCommandTest.java,34,3,37 ,"May 29, 2023"
2184,connect/runtime/src/main/java/org/apache/kafka/connect/runtime/isolation/DelegatingClassLoader.java,21,46,67 ,"May 26, 2023"
2185,connect/runtime/src/main/java/org/apache/kafka/connect/runtime/isolation/Plugins.java,5,0,5 ,"May 26, 2023"
2186,connect/runtime/src/test/java/org/apache/kafka/connect/runtime/isolation/DelegatingClassLoaderTest.java,0,17,17 ,"May 26, 2023"
2187,connect/runtime/src/test/java/org/apache/kafka/connect/runtime/isolation/PluginsTest.java,30,0,30 ,"May 26, 2023"
2188,connect/runtime/src/test/java/org/apache/kafka/connect/runtime/isolation/TestPlugins.java,9,1,10 ,"May 26, 2023"
2189,connect/runtime/src/test/resources/test-plugins/subclass-of-classpath/META-INF/services/org.apache.kafka.connect.connector.policy.ConnectorClientConfigOverridePolicy,16,0,16 ,"May 26, 2023"
2190,connect/runtime/src/test/resources/test-plugins/subclass-of-classpath/test/plugins/SubclassOfClasspathConverter.java,28,0,28 ,"May 26, 2023"
2191,connect/runtime/src/test/resources/test-plugins/subclass-of-classpath/test/plugins/SubclassOfClasspathOverridePolicy.java,29,0,29 ,"May 26, 2023"
2192,checkstyle/import-control.xml,3,1,4 ,"Jun 1, 2023"
2193,group-coordinator/src/main/java/org/apache/kafka/coordinator/group/runtime/CoordinatorEvent.java,36,0,36 ,"Jun 1, 2023"
2194,group-coordinator/src/main/java/org/apache/kafka/coordinator/group/runtime/CoordinatorEventProcessor.java,33,0,33 ,"Jun 1, 2023"
2195,group-coordinator/src/main/java/org/apache/kafka/coordinator/group/runtime/EventAccumulator.java,3,2,5 ,"Jun 1, 2023"
2196,group-coordinator/src/main/java/org/apache/kafka/coordinator/group/runtime/MultiThreadedEventProcessor.java,188,0,188 ,"Jun 1, 2023"
2197,group-coordinator/src/test/java/org/apache/kafka/coordinator/group/runtime/EventAccumulatorTest.java,1,1,2 ,"Jun 1, 2023"
2198,clients/src/main/java/org/apache/kafka/clients/consumer/MockConsumer.java,18,2,20 ,"May 26, 2023"
2199,clients/src/test/java/org/apache/kafka/clients/consumer/MockConsumerTest.java,47,0,47 ,"May 26, 2023"
2200,metadata/src/main/java/org/apache/kafka/controller/QuorumController.java,0,1,1,"May 26, 2023"
2201,.asf.yaml,2,2,4 ,"Jun 1, 2023"
2202,core/src/test/scala/integration/kafka/server/FetchFromFollowerIntegrationTest.scala,10,3,13 ,"May 30, 2023"
2203,streams/src/main/java/org/apache/kafka/streams/StreamsBuilder.java,6,3,9 ,"Jun 1, 2023"
2204,streams/src/main/java/org/apache/kafka/streams/kstream/CogroupedKStream.java,8,4,12 ,"Jun 1, 2023"
2205,streams/src/main/java/org/apache/kafka/streams/kstream/KGroupedStream.java,12,6,18 ,"Jun 1, 2023"
2206,streams/src/main/java/org/apache/kafka/streams/kstream/KGroupedTable.java,12,6,18 ,"Jun 1, 2023"
2207,checkstyle/import-control.xml,1,0,1,"May 26, 2023"
2208,connect/api/src/main/java/org/apache/kafka/connect/sink/SinkConnector.java,32,0,32 ,"May 26, 2023"
2209,connect/api/src/main/java/org/apache/kafka/connect/source/SourceConnector.java,31,0,31 ,"May 26, 2023"
2210,connect/runtime/src/main/java/org/apache/kafka/connect/runtime/Herder.java,9,0,9 ,"May 26, 2023"
2211,connect/json/src/main/java/org/apache/kafka/connect/json/JsonDeserializer.java,5,2,7 ,"Jun 2, 2023"
2212,connect/json/src/test/java/org/apache/kafka/connect/json/JsonConverterTest.java,8,0,8 ,"Jun 2, 2023"
2213,core/src/main/scala/kafka/zk/ZkMigrationClient.scala,37,35,72 ,"May 27, 2023"
2214,core/src/main/scala/kafka/zk/migration/ZkConfigMigrationClient.scala,30,2,32 ,"May 27, 2023"
2215,core/src/main/scala/kafka/zk/migration/ZkTopicMigrationClient.scala,0,7,7 ,"May 27, 2023"
2216,core/src/test/scala/unit/kafka/zk/migration/ZkConfigMigrationClientTest.scala,18,0,18 ,"May 27, 2023"
2217,core/src/test/scala/unit/kafka/zk/migration/ZkMigrationClientTest.scala,115,10,125 ,"May 27, 2023"
2218,core/src/test/scala/unit/kafka/zk/migration/ZkMigrationTestHarness.scala,2,0,2 ,"May 27, 2023"
2219,metadata/src/main/java/org/apache/kafka/metadata/migration/ConfigMigrationClient.java,5,0,5 ,"May 27, 2023"
2220,metadata/src/main/java/org/apache/kafka/metadata/migration/KRaftMigrationDriver.java,1,1,2 ,"May 27, 2023"
2221,core/src/test/scala/integration/kafka/server/KRaftClusterTest.scala,28,0,28 ,"May 31, 2023"
2222,metadata/src/main/java/org/apache/kafka/controller/BrokerHeartbeatManager.java,2,2,4 ,"May 31, 2023"
2223,metadata/src/main/java/org/apache/kafka/controller/ClusterControlManager.java,4,1,5 ,"May 31, 2023"
2224,metadata/src/main/java/org/apache/kafka/controller/QuorumController.java,8,2,10 ,"May 31, 2023"
2225,metadata/src/main/java/org/apache/kafka/controller/ReplicationControlManager.java,20,1,21 ,"May 31, 2023"
2226,metadata/src/main/java/org/apache/kafka/controller/errors/ControllerExceptions.java,41,0,41 ,"May 31, 2023"
2227,metadata/src/main/java/org/apache/kafka/controller/metrics/QuorumControllerMetrics.java,13,0,13 ,"May 31, 2023"
2228,group-coordinator/src/main/java/org/apache/kafka/coordinator/group/GroupMetadataManager.java,6,5,11 ,"Jun 2, 2023"
2229,connect/runtime/src/main/java/org/apache/kafka/connect/runtime/WorkerConfig.java,2,8,10 ,"May 26, 2023"
2230,connect/runtime/src/main/java/org/apache/kafka/connect/runtime/isolation/DelegatingClassLoader.java,17,39,56 ,"May 26, 2023"
2231,connect/runtime/src/main/java/org/apache/kafka/connect/runtime/isolation/PluginUtils.java,29,2,31 ,"May 26, 2023"
2232,connect/runtime/src/main/java/org/apache/kafka/connect/runtime/isolation/Plugins.java,5,3,8 ,"May 26, 2023"
2233,connect/runtime/src/test/java/org/apache/kafka/connect/runtime/isolation/DelegatingClassLoaderTest.java,6,8,14 ,"May 26, 2023"
2234,connect/runtime/src/test/java/org/apache/kafka/connect/runtime/isolation/PluginsTest.java,4,3,7 ,"May 26, 2023"
2235,connect/runtime/src/test/java/org/apache/kafka/connect/runtime/isolation/SynchronizationTest.java,6,5,11 ,"May 26, 2023"
2236,checkstyle/import-control-metadata.xml,1,0,1,"May 26, 2023"
2237,core/src/test/scala/integration/kafka/server/KRaftClusterTest.scala,30,0,30 ,"May 26, 2023"
2238,metadata/src/main/java/org/apache/kafka/controller/AclControlManager.java,10,1,11 ,"May 26, 2023"
2239,metadata/src/main/java/org/apache/kafka/controller/ClientQuotaControlManager.java,5,1,6 ,"May 26, 2023"
2240,metadata/src/main/java/org/apache/kafka/controller/ConfigurationControlManager.java,8,3,11 ,"May 26, 2023"
2241,metadata/src/main/java/org/apache/kafka/controller/FeatureControlManager.java,4,2,6 ,"May 26, 2023"
2242,metadata/src/main/java/org/apache/kafka/controller/QuorumController.java,20,2,22 ,"May 26, 2023"
2243,metadata/src/main/java/org/apache/kafka/controller/ReplicationControlManager.java,10,7,17 ,"May 26, 2023"
2244,metadata/src/test/java/org/apache/kafka/controller/ClientQuotaControlManagerTest.java,1,0,1,"May 26, 2023"
2245,connect/runtime/src/main/java/org/apache/kafka/connect/runtime/WorkerConfig.java,1,1,2 ,"May 31, 2023"
2246,clients/src/test/java/org/apache/kafka/clients/consumer/internals/DefaultBackgroundThreadTest.java,7,3,10 ,"May 26, 2023"
2247,core/src/main/scala/kafka/zk/migration/ZkTopicMigrationClient.scala,87,14,101 ,"Jun 1, 2023"
2248,core/src/test/scala/integration/kafka/zk/ZkMigrationIntegrationTest.scala,84,1,85 ,"Jun 1, 2023"
2249,core/src/test/scala/unit/kafka/zk/migration/ZkMigrationClientTest.scala,57,1,58 ,"Jun 1, 2023"
2250,metadata/src/main/java/org/apache/kafka/image/TopicDelta.java,23,0,23 ,"Jun 1, 2023"
2251,metadata/src/main/java/org/apache/kafka/metadata/PartitionRegistration.java,6,0,6 ,"Jun 1, 2023"
2252,tools/src/main/java/org/apache/kafka/tools/MetadataQuorumCommand.java,1,1,2 ,"May 31, 2023"
2253,tools/src/test/java/org/apache/kafka/tools/MetadataQuorumCommandErrorTest.java,4,2,6 ,"May 31, 2023"
2254,connect/runtime/src/main/java/org/apache/kafka/connect/runtime/isolation/DelegatingClassLoader.java,4,3,7 ,"Jun 2, 2023"
2255,connect/runtime/src/test/java/org/apache/kafka/connect/runtime/isolation/PluginsTest.java,13,0,13 ,"Jun 2, 2023"
2256,connect/runtime/src/test/java/org/apache/kafka/connect/runtime/isolation/TestPlugins.java,9,1,10 ,"Jun 2, 2023"
2257,connect/runtime/src/test/resources/test-plugins/bad-packaging/META-INF/services/org.apache.kafka.connect.connector.policy.ConnectorClientConfigOverridePolicy,16,0,16 ,"Jun 2, 2023"
2258,connect/runtime/src/test/resources/test-plugins/bad-packaging/test/plugins/NoDefaultConstructorConverter.java,49,0,49 ,"Jun 2, 2023"
2259,connect/runtime/src/test/resources/test-plugins/bad-packaging/test/plugins/NoDefaultConstructorOverridePolicy.java,53,0,53 ,"Jun 2, 2023"
2260,LICENSE-binary,1,1,2 ,"Jun 1, 2023"
2261,gradle/dependencies.gradle,2,0,2 ,"Jun 1, 2023"
2262,core/src/main/scala/kafka/zk/ZkMigrationClient.scala,6,0,6 ,"Jun 1, 2023"
2263,core/src/test/scala/integration/kafka/zk/ZkMigrationIntegrationTest.scala,10,7,17 ,"Jun 1, 2023"
2264,core/src/test/scala/unit/kafka/zk/migration/ZkAclMigrationClientTest.scala,2,3,5 ,"Jun 1, 2023"
2265,core/src/test/scala/unit/kafka/zk/migration/ZkConfigMigrationClientTest.scala,4,3,7 ,"Jun 1, 2023"
2266,core/src/test/scala/unit/kafka/zk/migration/ZkMigrationClientTest.scala,4,4,8 ,"Jun 1, 2023"
2267,metadata/src/main/java/org/apache/kafka/metadata/migration/KRaftMigrationDriver.java,85,25,110 ,"Jun 1, 2023"
2268,metadata/src/main/java/org/apache/kafka/metadata/migration/KRaftMigrationOperationConsumer.java,23,0,23 ,"Jun 1, 2023"
2269,connect/json/src/main/java/org/apache/kafka/connect/json/JsonConverter.java,1,1,2 ,"May 31, 2023"
2270,connect/json/src/test/java/org/apache/kafka/connect/json/JsonConverterTest.java,39,0,39 ,"May 31, 2023"
2271,clients/src/main/java/org/apache/kafka/clients/consumer/ConsumerPartitionAssignor.java,3,1,4 ,"May 5, 2023"
2272,clients/src/test/java/org/apache/kafka/clients/consumer/ConsumerPartitionAssignorTest.java,24,1,25 ,"May 5, 2023"
2273,streams/src/main/java/org/apache/kafka/streams/processor/internals/InternalTopologyBuilder.java,1,1,2 ,"May 2, 2023"
2274,streams/src/main/java/org/apache/kafka/streams/processor/internals/TaskManager.java,1,1,2 ,"May 2, 2023"
2275,streams/src/main/java/org/apache/kafka/streams/processor/internals/TopologyMetadata.java,1,1,2 ,"May 2, 2023"
2276,core/src/main/scala/kafka/server/SharedServer.scala,6,6,12 ,"May 11, 2023"
2277,core/src/test/scala/integration/kafka/api/PlaintextAdminIntegrationTest.scala,18,7,25 ,"May 8, 2023"
2278,streams/src/main/java/org/apache/kafka/streams/state/internals/VersionedKeyValueToBytesStoreAdapter.java,1,1,2 ,"May 10, 2023"
2279,examples/src/main/java/kafka/examples/Consumer.java,106,58,164 ,"May 2, 2023"
2280,examples/src/main/java/kafka/examples/ExactlyOnceMessageProcessor.java,4,2,6 ,"May 2, 2023"
2281,examples/src/main/java/kafka/examples/KafkaConsumerProducerDemo.java,2,1,3 ,"May 2, 2023"
2282,examples/src/main/java/kafka/examples/KafkaExactlyOnceDemo.java,2,1,3 ,"May 2, 2023"
2283,examples/src/main/java/kafka/examples/Utils.java,106,0,106 ,"May 2, 2023"
2284,server-common/src/main/java/org/apache/kafka/timeline/SnapshottableHashTable.java,3,0,3 ,"May 3, 2023"
2285,server-common/src/test/java/org/apache/kafka/timeline/SnapshottableHashTableTest.java,26,0,26 ,"May 3, 2023"
2286,streams/upgrade-system-tests-24/src/test/java/org/apache/kafka/streams/tests/StreamsUpgradeTest.java,1,2,3 ,"May 8, 2023"
2287,streams/upgrade-system-tests-25/src/test/java/org/apache/kafka/streams/tests/StreamsUpgradeTest.java,1,2,3 ,"May 8, 2023"
2288,streams/upgrade-system-tests-26/src/test/java/org/apache/kafka/streams/tests/StreamsUpgradeTest.java,1,2,3 ,"May 8, 2023"
2289,streams/upgrade-system-tests-27/src/test/java/org/apache/kafka/streams/tests/StreamsUpgradeTest.java,1,2,3 ,"May 8, 2023"
2290,streams/upgrade-system-tests-28/src/test/java/org/apache/kafka/streams/tests/StreamsUpgradeTest.java,1,2,3 ,"May 8, 2023"
2291,streams/upgrade-system-tests-30/src/test/java/org/apache/kafka/streams/tests/StreamsUpgradeTest.java,1,2,3 ,"May 8, 2023"
2292,streams/upgrade-system-tests-31/src/test/java/org/apache/kafka/streams/tests/StreamsUpgradeTest.java,1,2,3 ,"May 8, 2023"
2293,streams/upgrade-system-tests-32/src/test/java/org/apache/kafka/streams/tests/StreamsUpgradeTest.java,1,2,3 ,"May 8, 2023"
2294,streams/upgrade-system-tests-33/src/test/java/org/apache/kafka/streams/tests/StreamsUpgradeTest.java,1,2,3 ,"May 8, 2023"
2295,tests/kafkatest/tests/streams/streams_upgrade_test.py,7,3,10 ,"May 8, 2023"
2296,tests/kafkatest/version.py,3,6,9 ,"May 8, 2023"
2297,bin/kafka-log-dirs.sh,1,1,2 ,"May 4, 2023"
2298,bin/windows/kafka-log-dirs.bat,1,1,2 ,"May 4, 2023"
2299,clients/src/test/java/org/apache/kafka/clients/admin/MockAdminClient.java,31,1,32 ,"May 4, 2023"
2300,core/src/main/scala/kafka/admin/LogDirsCommand.scala,0,132,132 ,"May 4, 2023"
2301,core/src/test/scala/unit/kafka/admin/LogDirsCommandTest.scala,0,76,76 ,"May 4, 2023"
2302,clients/src/main/java/org/apache/kafka/common/utils/ThreadUtils.java,18,3,21 ,"May 8, 2023"
2303,connect/runtime/src/main/java/org/apache/kafka/connect/runtime/SourceTaskOffsetCommitter.java,1,8,9 ,"May 8, 2023"
2304,connect/runtime/src/main/java/org/apache/kafka/connect/runtime/Worker.java,2,14,16 ,"May 8, 2023"
2305,connect/runtime/src/main/java/org/apache/kafka/connect/runtime/distributed/DistributedHerder.java,3,16,19 ,"May 8, 2023"
2306,connect/runtime/src/main/java/org/apache/kafka/connect/runtime/standalone/StandaloneHerder.java,2,8,10 ,"May 8, 2023"
2307,connect/runtime/src/main/java/org/apache/kafka/connect/storage/MemoryOffsetBackingStore.java,1,12,13 ,"May 8, 2023"
2308,connect/runtime/src/test/java/org/apache/kafka/connect/runtime/SourceTaskOffsetCommitterTest.java,2,1,3 ,"May 8, 2023"
2309,clients/src/test/java/org/apache/kafka/common/message/SimpleExampleMessageTest.java,26,2,28 ,"May 3, 2023"
2310,clients/src/test/resources/common/message/SimpleExampleMessage.json,2,0,2 ,"May 3, 2023"
2311,generator/src/main/java/org/apache/kafka/message/MessageDataGenerator.java,2,2,4 ,"May 3, 2023"
2312,server-common/src/main/java/org/apache/kafka/queue/KafkaEventQueue.java,5,5,10 ,"May 2, 2023"
2313,clients/src/main/java/org/apache/kafka/clients/consumer/internals/AsyncClient.java,0,4,4 ,"May 2, 2023"
2314,clients/src/main/java/org/apache/kafka/common/protocol/types/TaggedFields.java,0,5,5 ,"May 2, 2023"
2315,clients/src/main/java/org/apache/kafka/common/record/AbstractLegacyRecordBatch.java,0,5,5 ,"May 2, 2023"
2316,clients/src/main/java/org/apache/kafka/common/record/DefaultRecordBatch.java,0,5,5 ,"May 2, 2023"
2317,connect/mirror/src/main/java/org/apache/kafka/connect/mirror/DefaultConfigPropertyFilter.java,0,4,4 ,"May 2, 2023"
2318,connect/mirror/src/main/java/org/apache/kafka/connect/mirror/DefaultGroupFilter.java,0,4,4 ,"May 2, 2023"
2319,connect/mirror/src/main/java/org/apache/kafka/connect/mirror/DefaultTopicFilter.java,0,4,4 ,"May 2, 2023"
2320,connect/mirror/src/main/java/org/apache/kafka/connect/mirror/MirrorHeartbeatConfig.java,0,5,5 ,"May 2, 2023"
2321,connect/mirror/src/main/java/org/apache/kafka/connect/mirror/MirrorSourceConfig.java,0,5,5 ,"May 2, 2023"
2322,connect/mirror/src/test/java/org/apache/kafka/connect/mirror/MirrorSourceConnectorTest.java,0,4,4 ,"May 2, 2023"
2323,connect/runtime/src/main/java/org/apache/kafka/connect/runtime/InternalSinkRecord.java,0,5,5 ,"May 2, 2023"
2324,connect/runtime/src/main/java/org/apache/kafka/connect/runtime/SourceConnectorConfig.java,0,4,4 ,"May 2, 2023"
2325,connect/runtime/src/main/java/org/apache/kafka/connect/runtime/WorkerSinkTask.java,0,5,5 ,"May 2, 2023"
2326,connect/runtime/src/main/java/org/apache/kafka/connect/tools/MockSinkTask.java,0,7,7 ,"May 2, 2023"
2327,clients/src/main/java/org/apache/kafka/clients/producer/KafkaProducer.java,3,2,5 ,"May 4, 2023"
2328,clients/src/main/java/org/apache/kafka/clients/producer/internals/Sender.java,21,1,22 ,"May 4, 2023"
2329,clients/src/main/java/org/apache/kafka/clients/producer/internals/TransactionManager.java,38,21,59 ,"May 4, 2023"
2330,clients/src/test/java/org/apache/kafka/clients/producer/KafkaProducerTest.java,30,0,30 ,"May 4, 2023"
2331,clients/src/test/java/org/apache/kafka/clients/producer/internals/SenderTest.java,26,1,27 ,"May 4, 2023"
2332,clients/src/test/java/org/apache/kafka/clients/producer/internals/TransactionManagerTest.java,1,1,2 ,"May 4, 2023"
2333,core/src/test/scala/integration/kafka/api/AuthorizerIntegrationTest.scala,24,0,24 ,"May 4, 2023"
2334,docs/connect.html,3,2,5 ,"May 2, 2023"
2335,group-coordinator/src/main/java/org/apache/kafka/coordinator/group/consumer/ConsumerGroupMember.java,4,0,4 ,"May 8, 2023"
2336,core/src/main/scala/kafka/log/LogCleaner.scala,31,12,43 ,"May 5, 2023"
2337,core/src/test/scala/unit/kafka/log/LogCleanerTest.scala,30,0,30 ,"May 5, 2023"
2338,docs/security.html,126,0,126 ,"May 8, 2023"
2339,metadata/src/main/java/org/apache/kafka/metadata/util/RecordRedactor.java,0,2,2 ,"May 4, 2023"
